//MAP CONVERTED BY dmm2tgm.py THIS HEADER COMMENT PREVENTS RECONVERSION, DO NOT REMOVE
"a" = (
/turf/floor/tiled/steel/monofloor,
/area/deepmaint)
"b" = (
/obj/structure/barricade,
/turf/floor/tiled/techmaint_panels,
/area/deepmaint)
"c" = (
/turf/wall,
/area/deepmaint)
"d" = (
/obj/spawner/junk,
/turf/floor/tiled/techmaint_cargo,
/area/deepmaint)
"e" = (
/obj/spawner/pack/machine,
/turf/floor/tiled/techmaint_perforated,
/area/deepmaint)
"f" = (
/turf/floor/tiled/techmaint,
/area/deepmaint)
"g" = (
/obj/structure/table/rack/shelf,
/obj/spawner/pack/tech_loot,
/obj/spawner/pack/tech_loot,
/obj/spawner/pack/tech_loot/low_chance,
/obj/spawner/pack/tech_loot/low_chance,
/turf/floor/tiled/techmaint_perforated,
/area/deepmaint)
"h" = (
/obj/spawner/junk,
/turf/floor/tiled/techmaint,
/area/deepmaint)
"j" = (
/obj/spawner/mob/roaches/cluster/low_chance,
/turf/floor/tiled/techmaint,
/area/deepmaint)
"k" = (
/obj/structure/table/standard,
/obj/spawner/pack/rare/low_chance,
/turf/floor/tiled/techmaint_perforated,
/area/deepmaint)
"l" = (
/obj/structure/table/standard,
/obj/spawner/pack/rare/low_chance,
/obj/spawner/pack/rare,
/turf/floor/tiled/techmaint_perforated,
/area/deepmaint)
"m" = (
/obj/structure/table/rack/shelf,
/obj/spawner/pack/cloth,
/obj/spawner/pack/cloth,
/obj/spawner/pack/cloth/low_chance,
/turf/floor/tiled/techmaint_perforated,
/area/deepmaint)
"n" = (
/turf/floor/tiled/techmaint_cargo,
/area/deepmaint)
"o" = (
/obj/structure/table/rack/shelf,
/obj/spawner/pack/tech_loot,
/obj/spawner/pack/tech_loot,
/obj/spawner/pack/tech_loot/low_chance,
/obj/spawner/pack/tech_loot/low_chance,
/obj/machinery/light/small{
	dir = 1
	},
/turf/floor/tiled/techmaint_perforated,
/area/deepmaint)
"p" = (
/obj/structure/table/rack/shelf,
/obj/spawner/pack/cloth,
/obj/spawner/pack/cloth,
/obj/spawner/pack/cloth/low_chance,
/obj/machinery/light/small,
/turf/floor/tiled/techmaint_perforated,
/area/deepmaint)
"y" = (
/obj/item/stool,
/turf/floor/tiled/techmaint_perforated,
/area/deepmaint)
"K" = (
/obj/landmark/corpse/hobo,
/turf/floor/tiled/techmaint,
/area/deepmaint)

(1,1,1) = {"
a
a
a
a
a
a
a
a
a
a
a
"}
(2,1,1) = {"
b
c
c
c
c
c
c
c
c
c
b
"}
(3,1,1) = {"
b
c
e
e
e
e
e
e
e
c
b
"}
(4,1,1) = {"
b
d
f
f
f
j
f
h
f
n
b
"}
(5,1,1) = {"
b
c
g
h
y
k
y
f
m
c
b
"}
(6,1,1) = {"
b
c
o
K
y
l
y
j
p
c
b
"}
(7,1,1) = {"
b
c
g
f
y
k
y
f
m
c
b
"}
(8,1,1) = {"
b
d
f
f
f
j
f
h
f
d
b
"}
(9,1,1) = {"
b
c
e
e
e
e
e
e
e
c
b
"}
(10,1,1) = {"
b
c
c
c
c
c
c
c
c
c
b
"}
(11,1,1) = {"
a
a
a
a
a
a
a
a
a
a
a
"}
