"a" = (/obj/structure/catwalk,/turf/simulated/floor/plating/under,/area/deepmaint)
"b" = (/obj/structure/catwalk,/obj/machinery/atmospherics/pipe/simple/visible/yellow{dir = 4},/turf/simulated/floor/plating/under,/area/deepmaint)
"c" = (/obj/structure/railing{tag = "icon-railing0 (NORTH)"; icon_state = "railing0"; dir = 1},/obj/structure/railing{tag = "icon-railing0 (WEST)"; icon_state = "railing0"; dir = 8},/obj/machinery/atmospherics/pipe/simple/visible/yellow{dir = 4},/turf/simulated/floor/plating/under,/area/deepmaint)
"d" = (/obj/structure/railing{tag = "icon-railing0 (NORTH)"; icon_state = "railing0"; dir = 1},/obj/spawner/junk/low_chance,/obj/machinery/atmospherics/pipe/simple/visible/yellow{dir = 4},/turf/simulated/floor/plating/under,/area/deepmaint)
"e" = (/obj/structure/railing{tag = "icon-railing0 (NORTH)"; icon_state = "railing0"; dir = 1},/obj/machinery/atmospherics/pipe/simple/visible/yellow{dir = 4},/turf/simulated/floor/plating/under,/area/deepmaint)
"f" = (/obj/structure/railing{tag = "icon-railing0 (EAST)"; icon_state = "railing0"; dir = 4},/obj/structure/railing{tag = "icon-railing0 (NORTH)"; icon_state = "railing0"; dir = 1},/obj/machinery/atmospherics/pipe/simple/visible/yellow{dir = 4},/turf/simulated/floor/plating/under,/area/deepmaint)
"g" = (/obj/structure/railing{tag = "icon-railing0 (WEST)"; icon_state = "railing0"; dir = 8},/obj/structure/railing,/turf/simulated/floor/plating/under,/area/deepmaint)
"h" = (/obj/structure/railing,/turf/simulated/floor/plating/under,/area/deepmaint)
"i" = (/obj/structure/railing,/obj/spawner/junk/low_chance,/turf/simulated/floor/plating/under,/area/deepmaint)
"j" = (/obj/structure/railing{tag = "icon-railing0 (EAST)"; icon_state = "railing0"; dir = 4},/obj/structure/railing,/turf/simulated/floor/plating/under,/area/deepmaint)
"k" = (/obj/structure/catwalk,/obj/spawner/mob/roaches/cluster/low_chance,/turf/simulated/floor/plating/under,/area/deepmaint)
"l" = (/obj/structure/railing{tag = "icon-railing0 (NORTH)"; icon_state = "railing0"; dir = 1},/obj/structure/railing{tag = "icon-railing0 (WEST)"; icon_state = "railing0"; dir = 8},/turf/simulated/floor/plating/under,/area/deepmaint)
"m" = (/obj/structure/railing{tag = "icon-railing0 (NORTH)"; icon_state = "railing0"; dir = 1},/obj/structure/railing{tag = "icon-railing0 (EAST)"; icon_state = "railing0"; dir = 4},/turf/simulated/floor/plating/under,/area/deepmaint)
"n" = (/obj/structure/table/standard,/obj/spawner/pack/tech_loot,/obj/spawner/pack/tech_loot,/obj/spawner/pack/tech_loot,/obj/spawner/pack/tech_loot/low_chance,/obj/spawner/pack/tech_loot/low_chance,/turf/simulated/floor/tiled/techmaint_perforated,/area/deepmaint)
"o" = (/obj/structure/table/standard,/turf/simulated/floor/tiled/techmaint_perforated,/area/deepmaint)
"p" = (/obj/structure/railing{tag = "icon-railing0 (EAST)"; icon_state = "railing0"; dir = 4},/obj/structure/railing{tag = "icon-railing0 (NORTH)"; icon_state = "railing0"; dir = 1},/turf/simulated/floor/plating/under,/area/deepmaint)
"q" = (/obj/structure/railing{tag = "icon-railing0 (WEST)"; icon_state = "railing0"; dir = 8},/obj/spawner/junk/low_chance,/turf/simulated/floor/plating/under,/area/deepmaint)
"r" = (/obj/structure/railing{tag = "icon-railing0 (EAST)"; icon_state = "railing0"; dir = 4},/obj/spawner/junk/low_chance,/obj/structure/railing,/turf/simulated/floor/plating/under,/area/deepmaint)
"s" = (/obj/structure/table/standard,/obj/spawner/pack/rare/low_chance,/obj/spawner/pack/rare/low_chance,/turf/simulated/floor/tiled/techmaint_perforated,/area/deepmaint)
"t" = (/obj/structure/bed/chair{dir = 1},/turf/simulated/floor/tiled/techmaint_perforated,/area/deepmaint)
"u" = (/obj/structure/railing{tag = "icon-railing0 (WEST)"; icon_state = "railing0"; dir = 8},/obj/spawner/junk/low_chance,/obj/structure/railing,/turf/simulated/floor/plating/under,/area/deepmaint)
"v" = (/obj/structure/railing{tag = "icon-railing0 (EAST)"; icon_state = "railing0"; dir = 4},/obj/spawner/junk/low_chance,/turf/simulated/floor/plating/under,/area/deepmaint)
"w" = (/obj/structure/railing{tag = "icon-railing0 (WEST)"; icon_state = "railing0"; dir = 8},/obj/structure/railing,/obj/spawner/junk/low_chance,/obj/structure/railing{tag = "icon-railing0 (EAST)"; icon_state = "railing0"; dir = 4},/turf/simulated/floor/plating/under,/area/deepmaint)
"x" = (/obj/spawner/pack/machine,/turf/simulated/floor/tiled/techmaint_cargo,/area/deepmaint)
"y" = (/turf/simulated/floor/tiled/techmaint_cargo,/area/deepmaint)
"z" = (/turf/simulated/floor/tiled/techmaint_perforated,/area/deepmaint)
"A" = (/obj/structure/railing{tag = "icon-railing0 (EAST)"; icon_state = "railing0"; dir = 4},/obj/structure/railing,/obj/structure/railing{tag = "icon-railing0 (WEST)"; icon_state = "railing0"; dir = 8},/turf/simulated/floor/plating/under,/area/deepmaint)
"B" = (/obj/structure/railing{tag = "icon-railing0 (WEST)"; icon_state = "railing0"; dir = 8},/obj/structure/railing{tag = "icon-railing0 (NORTH)"; icon_state = "railing0"; dir = 1},/turf/simulated/floor/plating/under,/area/deepmaint)
"C" = (/obj/structure/railing{tag = "icon-railing0 (NORTH)"; icon_state = "railing0"; dir = 1},/turf/simulated/floor/plating/under,/area/deepmaint)
"D" = (/obj/structure/railing{tag = "icon-railing0 (NORTH)"; icon_state = "railing0"; dir = 1},/obj/spawner/junk/low_chance,/turf/simulated/floor/plating/under,/area/deepmaint)
"E" = (/obj/structure/railing,/obj/structure/railing{tag = "icon-railing0 (WEST)"; icon_state = "railing0"; dir = 8},/obj/machinery/atmospherics/pipe/simple/visible/yellow{dir = 4},/turf/simulated/floor/plating/under,/area/deepmaint)
"F" = (/obj/structure/railing,/obj/spawner/junk/low_chance,/obj/machinery/atmospherics/pipe/simple/visible/yellow{dir = 4},/turf/simulated/floor/plating/under,/area/deepmaint)
"G" = (/obj/structure/railing,/obj/machinery/atmospherics/pipe/simple/visible/yellow{dir = 4},/turf/simulated/floor/plating/under,/area/deepmaint)
"H" = (/obj/machinery/atmospherics/pipe/simple/visible/yellow{dir = 4},/obj/structure/railing,/turf/simulated/floor/plating/under,/area/deepmaint)
"I" = (/obj/structure/railing,/obj/structure/railing{tag = "icon-railing0 (EAST)"; icon_state = "railing0"; dir = 4},/obj/machinery/atmospherics/pipe/simple/visible/yellow{dir = 4},/turf/simulated/floor/plating/under,/area/deepmaint)

(1,1,1) = {"
aaaaaaaaaaa
bcdeeeeedfb
aghihihihja
aaakaaakaaa
almanonalpa
aqrastsauva
awxyzzzyxAa
aaaaaaaaaaa
aBCDCCCCDma
bEFGHFGFGIb
aaaaaaaaaaa
"}
