//MAP CONVERTED BY dmm2tgm.py THIS HEADER COMMENT PREVENTS RECONVERSION, DO NOT REMOVE
"b" = (
/obj/structure/catwalk,
/obj/item/material/shard/plasma{
	pixel_x = -5
	},
/obj/item/stack/material/steel/random,
/obj/effect/decal/cleanable/blood/drip,
/obj/item/trash/material/metal{
	pixel_x = 13;
	pixel_y = -4
	},
/obj/item/trash/material/metal{
	pixel_x = -6;
	pixel_y = 11
	},
/turf/floor/tiled/steel/techfloor_grid,
/area/deepmaint)
"d" = (
/obj/structure/catwalk,
/turf/floor/plating/under,
/area/deepmaint)
"f" = (
/obj/machinery/door/airlock/glass_science{
	name = "Nanite Research"
	},
/obj/structure/barricade,
/turf/floor/tiled/steel/techfloor_grid,
/area/deepmaint)
"j" = (
/obj/structure/table/standard,
/obj/structure/catwalk,
/obj/item/device/lighting/toggleable/lamp,
/obj/spawner/gun/normal,
/obj/spawner/pack/rare/low_chance,
/turf/floor/tiled/steel/techfloor_grid,
/area/deepmaint)
"k" = (
/obj/item/material/shard/plasma{
	pixel_y = -14
	},
/obj/effect/decal/cleanable/blood/drip,
/obj/machinery/door/blast/regular/open,
/obj/item/trash/material/metal{
	pixel_x = 7;
	pixel_y = 12
	},
/obj/item/trash/material/metal{
	pixel_x = -10;
	pixel_y = -6
	},
/turf/floor/tiled/steel/techfloor_grid,
/area/deepmaint)
"l" = (
/obj/structure/barricade,
/turf/wall/low,
/area/deepmaint)
"m" = (
/obj/item/material/shard/plasma{
	pixel_x = -5;
	pixel_y = 6
	},
/obj/effect/decal/cleanable/blood/drip,
/obj/item/trash/material/metal{
	pixel_x = 11;
	pixel_y = -3
	},
/obj/machinery/door/blast/regular/open,
/obj/item/trash/material/metal,
/turf/floor/tiled/steel/techfloor_grid,
/area/deepmaint)
"n" = (
/turf/wall/low/with_glass/smart_plasma,
/obj/machinery/door/blast/regular,
/area/deepmaint)
"o" = (
/mob/living/simple_animal/hostile/hivemind/mechiver{
	malfunction_chance = 0;
	name = "Test Subject Beta-149"
	},
/turf/floor/tiled/steel/techfloor_grid,
/area/deepmaint)
"p" = (
/obj/structure/table/standard,
/obj/structure/catwalk,
/obj/spawner/gun/shotgun/low_chance,
/obj/item/device/lighting/toggleable/lamp,
/turf/floor/tiled/steel/techfloor_grid,
/area/deepmaint)
"q" = (
/obj/structure/catwalk,
/obj/item/clothing/suit/storage/toggle/labcoat,
/obj/item/clothing/shoes/reinforced/medical,
/obj/structure/table/standard,
/obj/spawner/gun/cheap/low_chance,
/turf/floor/tiled/steel/techfloor_grid,
/area/deepmaint)
"s" = (
/obj/structure/catwalk,
/obj/structure/barricade,
/turf/floor/plating/under,
/area/deepmaint)
"t" = (
/obj/machinery/light/small{
	dir = 1
	},
/obj/item/trash/sosjerky,
/turf/floor/tiled/steel/techfloor_grid,
/area/deepmaint)
"u" = (
/turf/wall,
/area/deepmaint)
"v" = (
/obj/machinery/light/small{
	dir = 1
	},
/turf/floor/tiled/steel/techfloor_grid,
/area/deepmaint)
"w" = (
/obj/structure/catwalk,
/obj/item/clothing/suit/storage/toggle/labcoat,
/obj/item/clothing/shoes/reinforced/medical,
/obj/structure/table/standard,
/obj/spawner/pizza,
/obj/spawner/pack/rare/low_chance,
/turf/floor/tiled/steel/techfloor_grid,
/area/deepmaint)
"x" = (
/mob/living/simple_animal/hostile/hivemind/stinger{
	malfunction_chance = 0
	},
/turf/floor/tiled/steel/techfloor_grid,
/area/deepmaint)
"y" = (
/obj/item/material/shard/plasma{
	pixel_x = 5;
	pixel_y = 3
	},
/obj/item/material/shard/plasma{
	pixel_x = -7;
	pixel_y = 8
	},
/obj/item/stack/material/steel/random,
/obj/effect/decal/cleanable/blood,
/obj/machinery/door/blast/regular/open,
/obj/item/trash/material/metal{
	pixel_x = -5;
	pixel_y = 2
	},
/turf/floor/tiled/steel/techfloor_grid,
/area/deepmaint)
"A" = (
/obj/structure/table/standard,
/obj/structure/catwalk,
/obj/spawner/booze/low_chance,
/obj/item/trash/cigbutt/cigarbutt,
/turf/floor/tiled/steel/techfloor_grid,
/area/deepmaint)
"C" = (
/obj/effect/decal/cleanable/blood/drip,
/turf/floor/tiled/steel/techfloor_grid,
/area/deepmaint)
"D" = (
/obj/machinery/light/small,
/turf/floor/tiled/steel/techfloor_grid,
/area/deepmaint)
"G" = (
/obj/structure/table/standard,
/obj/structure/catwalk,
/obj/item/reagent_containers/glass/beaker/hivemind,
/obj/spawner/oddities/low_chance,
/turf/floor/tiled/steel/techfloor_grid,
/area/deepmaint)
"H" = (
/turf/floor/tiled/steel/techfloor_grid,
/area/deepmaint)
"I" = (
/obj/structure/table/standard,
/obj/structure/catwalk,
/obj/item/reagent_containers/glass/beaker/hivemind,
/obj/item/clothing/head/bio_hood,
/obj/item/clothing/suit/bio_suit,
/obj/item/clothing/shoes/reinforced/medical,
/obj/spawner/firstaid/low_chance,
/obj/spawner/medical,
/turf/floor/tiled/steel/techfloor_grid,
/area/deepmaint)
"J" = (
/obj/structure/table/standard,
/obj/structure/catwalk,
/obj/spawner/gun_parts/low_chance,
/obj/item/device/lighting/toggleable/lamp,
/obj/spawner/pack/tech_loot/low_chance,
/turf/floor/tiled/steel/techfloor_grid,
/area/deepmaint)
"K" = (
/obj/machinery/light/small{
	dir = 8
	},
/turf/floor/tiled/steel/techfloor_grid,
/area/deepmaint)
"L" = (
/mob/living/simple_animal/hostile/hivemind/hiborg{
	malfunction_chance = 0
	},
/turf/floor/tiled/steel/techfloor_grid,
/area/deepmaint)
"M" = (
/obj/machinery/light/small{
	dir = 4
	},
/obj/item/trash/mre_can,
/turf/floor/tiled/steel/techfloor_grid,
/area/deepmaint)
"N" = (
/obj/structure/table/standard,
/obj/structure/catwalk,
/obj/spawner/powercell,
/obj/spawner/gun/energy_cheap/low_chance,
/turf/floor/tiled/steel/techfloor_grid,
/area/deepmaint)
"O" = (
/obj/spawner/pack/rare/low_chance,
/turf/floor/tiled/steel/techfloor_grid,
/area/deepmaint)
"P" = (
/obj/machinery/light/small{
	dir = 4
	},
/turf/floor/tiled/steel/techfloor_grid,
/area/deepmaint)
"Q" = (
/mob/living/simple_animal/hostile/hivemind/himan{
	malfunction_chance = 0
	},
/turf/floor/tiled/steel/techfloor_grid,
/area/deepmaint)
"R" = (
/mob/living/simple_animal/hostile/hivemind/phaser,
/turf/floor/tiled/steel/techfloor_grid,
/area/deepmaint)
"T" = (
/mob/living/simple_animal/hostile/hivemind/lobber{
	malfunction_chance = 0
	},
/turf/floor/tiled/steel/techfloor_grid,
/area/deepmaint)
"V" = (
/obj/structure/catwalk,
/obj/spawner/pack/machine,
/turf/floor/tiled/steel/techfloor_grid,
/area/deepmaint)
"X" = (
/obj/structure/barricade,
/turf/wall/low/with_glass/smart,
/area/deepmaint)
"Y" = (
/obj/item/trash/wok,
/turf/floor/tiled/steel/techfloor_grid,
/area/deepmaint)
"Z" = (
/obj/structure/table/standard,
/obj/structure/catwalk,
/obj/spawner/soda,
/obj/spawner/rations/low_chance,
/obj/spawner/rations/low_chance,
/obj/spawner/rations/low_chance,
/obj/item/trash/tastybread,
/turf/floor/tiled/steel/techfloor_grid,
/area/deepmaint)

(1,1,1) = {"
d
d
d
d
d
d
d
s
d
d
d
"}
(2,1,1) = {"
d
u
X
u
u
f
l
u
X
u
d
"}
(3,1,1) = {"
s
u
v
H
K
T
C
K
Q
u
d
"}
(4,1,1) = {"
d
X
H
V
I
V
b
j
H
l
d
"}
(5,1,1) = {"
d
l
H
V
n
m
y
q
D
u
d
"}
(6,1,1) = {"
d
f
H
J
n
o
k
A
L
f
d
"}
(7,1,1) = {"
d
u
t
w
n
n
n
V
D
u
d
"}
(8,1,1) = {"
d
X
R
Z
N
V
G
p
O
u
d
"}
(9,1,1) = {"
d
u
M
Y
H
H
P
x
H
X
d
"}
(10,1,1) = {"
d
u
u
X
l
f
u
u
u
u
s
"}
(11,1,1) = {"
d
d
s
d
d
d
d
d
s
d
d
"}
