"d" = (/obj/structure/catwalk,/turf/simulated/floor/plating/under,/area/deepmaint)
"e" = (/obj/item/material/shard/plasma{pixel_x = 5; pixel_y = 3},/obj/item/material/shard/plasma{pixel_x = -7; pixel_y = 8},/obj/item/stack/material/steel/random,/obj/effect/decal/cleanable/blood,/obj/machinery/door/blast/regular/open,/obj/item/trash/material/metal{pixel_x = -5; pixel_y = 2},/turf/simulated/floor/tiled/steel/techfloor_grid,/area/deepmaint)
"f" = (/obj/machinery/door/airlock/glass_science{name = "Nanite Research"},/obj/structure/barricade,/turf/simulated/floor/tiled/steel/techfloor_grid,/area/deepmaint)
"h" = (/obj/item/material/shard/plasma{pixel_x = -5; pixel_y = 6},/obj/effect/decal/cleanable/blood/drip,/obj/item/trash/material/metal{pixel_x = 11; pixel_y = -3},/obj/machinery/door/blast/regular/open,/obj/item/trash/material/metal,/turf/simulated/floor/tiled/steel/techfloor_grid,/area/deepmaint)
"j" = (/obj/structure/table/standard,/obj/structure/catwalk,/obj/item/device/lighting/toggleable/lamp,/obj/spawner/gun/normal,/obj/spawner/pack/rare/low_chance,/turf/simulated/floor/tiled/steel/techfloor_grid,/area/deepmaint)
"l" = (/obj/structure/barricade,/obj/structure/low_wall,/turf/simulated/floor/plating/under,/area/deepmaint)
"n" = (/obj/effect/window_lwall_spawn/smartspawnplasma,/obj/machinery/door/blast/regular,/turf/simulated/floor/tiled/steel/techfloor_grid,/area/deepmaint)
"o" = (/mob/living/simple_animal/hostile/hivemind/mechiver{malfunction_chance = 0; name = "Test Subjet Beta-149"},/turf/simulated/floor/tiled/steel/techfloor_grid,/area/deepmaint)
"p" = (/obj/structure/table/standard,/obj/structure/catwalk,/obj/spawner/gun/shotgun/low_chance,/obj/item/device/lighting/toggleable/lamp,/turf/simulated/floor/tiled/steel/techfloor_grid,/area/deepmaint)
"q" = (/obj/structure/catwalk,/obj/item/clothing/suit/storage/toggle/labcoat,/obj/item/clothing/shoes/reinforced/medical,/obj/structure/table/standard,/obj/spawner/gun/cheap/low_chance,/turf/simulated/floor/tiled/steel/techfloor_grid,/area/deepmaint)
"s" = (/obj/structure/catwalk,/obj/structure/barricade,/turf/simulated/floor/plating/under,/area/deepmaint)
"t" = (/obj/machinery/light/small{dir = 1},/obj/item/trash/sosjerky,/turf/simulated/floor/tiled/steel/techfloor_grid,/area/deepmaint)
"u" = (/turf/simulated/wall,/area/deepmaint)
"v" = (/obj/machinery/light/small{dir = 1},/turf/simulated/floor/tiled/steel/techfloor_grid,/area/deepmaint)
"w" = (/obj/structure/catwalk,/obj/item/clothing/suit/storage/toggle/labcoat,/obj/item/clothing/shoes/reinforced/medical,/obj/structure/table/standard,/obj/spawner/pizza,/obj/spawner/pack/rare/low_chance,/turf/simulated/floor/tiled/steel/techfloor_grid,/area/deepmaint)
"x" = (/mob/living/simple_animal/hostile/hivemind/stinger{malfunction_chance = 0},/turf/simulated/floor/tiled/steel/techfloor_grid,/area/deepmaint)
"A" = (/obj/structure/table/standard,/obj/structure/catwalk,/obj/spawner/booze/low_chance,/obj/item/trash/cigbutt/cigarbutt,/turf/simulated/floor/tiled/steel/techfloor_grid,/area/deepmaint)
"B" = (/obj/item/material/shard/plasma{pixel_y = -14},/obj/effect/decal/cleanable/blood/drip,/obj/machinery/door/blast/regular/open,/obj/item/trash/material/metal{pixel_x = 7; pixel_y = 12},/obj/item/trash/material/metal{pixel_x = -10; pixel_y = -6},/turf/simulated/floor/tiled/steel/techfloor_grid,/area/deepmaint)
"C" = (/obj/effect/decal/cleanable/blood/drip,/turf/simulated/floor/tiled/steel/techfloor_grid,/area/deepmaint)
"D" = (/obj/machinery/light/small,/turf/simulated/floor/tiled/steel/techfloor_grid,/area/deepmaint)
"E" = (/obj/structure/catwalk,/obj/item/material/shard/plasma{pixel_x = -5},/obj/item/stack/material/steel/random,/obj/effect/decal/cleanable/blood/drip,/obj/item/trash/material/metal{pixel_x = 13; pixel_y = -4},/obj/item/trash/material/metal{pixel_x = -6; pixel_y = 11},/turf/simulated/floor/tiled/steel/techfloor_grid,/area/deepmaint)
"F" = (/obj/structure/table/standard,/obj/structure/catwalk,/obj/item/reagent_containers/glass/beaker/hivemind,/obj/item/clothing/head/bio_hoo,/obj/item/clothing/suit/bio_suit,/obj/item/clothing/shoes/reinforced/medical,/obj/spawner/firstaid/low_chance,/obj/spawner/medical,/turf/simulated/floor/tiled/steel/techfloor_grid,/area/deepmaint)
"H" = (/turf/simulated/floor/tiled/steel/techfloor_grid,/area/deepmaint)
"J" = (/obj/structure/table/standard,/obj/structure/catwalk,/obj/spawner/gun_parts/low_chance,/obj/item/device/lighting/toggleable/lamp,/obj/spawner/pack/tech_loot/low_chance,/turf/simulated/floor/tiled/steel/techfloor_grid,/area/deepmaint)
"K" = (/obj/machinery/light/small{dir = 8},/turf/simulated/floor/tiled/steel/techfloor_grid,/area/deepmaint)
"L" = (/mob/living/simple_animal/hostile/hivemind/hiborg{malfunction_chance = 0},/turf/simulated/floor/tiled/steel/techfloor_grid,/area/deepmaint)
"M" = (/obj/machinery/light/small{dir = 4},/obj/item/trash/mre_can,/turf/simulated/floor/tiled/steel/techfloor_grid,/area/deepmaint)
"N" = (/obj/structure/table/standard,/obj/structure/catwalk,/obj/spawner/powercell,/obj/spawner/gun/energy_cheap/low_chance,/turf/simulated/floor/tiled/steel/techfloor_grid,/area/deepmaint)
"O" = (/obj/spawner/pack/rare/low_chance,/turf/simulated/floor/tiled/steel/techfloor_grid,/area/deepmaint)
"P" = (/obj/machinery/light/small{dir = 4},/turf/simulated/floor/tiled/steel/techfloor_grid,/area/deepmaint)
"Q" = (/mob/living/simple_animal/hostile/hivemind/himan{malfunction_chance = 0},/turf/simulated/floor/tiled/steel/techfloor_grid,/area/deepmaint)
"R" = (/mob/living/simple_animal/hostile/hivemind/phaser,/turf/simulated/floor/tiled/steel/techfloor_grid,/area/deepmaint)
"T" = (/mob/living/simple_animal/hostile/hivemind/lobber{malfunction_chance = 0},/turf/simulated/floor/tiled/steel/techfloor_grid,/area/deepmaint)
"V" = (/obj/structure/catwalk,/obj/spawner/pack/machine,/turf/simulated/floor/tiled/steel/techfloor_grid,/area/deepmaint)
"W" = (/obj/structure/table/standard,/obj/structure/catwalk,/obj/item/reagent_containers/glass/beaker/hivemind,/obj/spawner/oddities/low_chance,/turf/simulated/floor/tiled/steel/techfloor_grid,/area/deepmaint)
"X" = (/obj/effect/window_lwall_spawn/smartspawn,/obj/structure/barricade,/turf/simulated/floor/plating/under,/area/deepmaint)
"Y" = (/obj/item/trash/syndi_cakes,/turf/simulated/floor/tiled/steel/techfloor_grid,/area/deepmaint)
"Z" = (/obj/structure/table/standard,/obj/structure/catwalk,/obj/spawner/soda,/obj/spawner/rations/low_chance,/obj/spawner/rations/low_chance,/obj/spawner/rations/low_chance,/obj/item/trash/tastybread,/turf/simulated/floor/tiled/steel/techfloor_grid,/area/deepmaint)

(1,1,1) = {"
ddsdddddddd
duuXlfuXuud
dXvHHHtRMus
duHVVJwZYXd
duKFnnnNHld
dfTVhonVHfd
dlCEeBnWPud
suKjqAVpxud
dXQHDLDOHus
duulufuuXud
dddddddddsd
"}
