//MAP CONVERTED BY dmm2tgm.py THIS HEADER COMMENT PREVENTS RECONVERSION, DO NOT REMOVE
"a" = (
/turf/simulated/floor/tiled/steel/brown_platform,
/area/deepmaint)
"b" = (
/turf/simulated/wall,
/area/deepmaint)
"c" = (
/obj/effect/window_lwall_spawn/smartspawn,
/turf/simulated/floor/plating,
/area/deepmaint)
"d" = (
/obj/spawner/mob/roaches/cluster/low_chance,
/turf/simulated/floor/tiled/steel/brown_platform,
/area/deepmaint)
"e" = (
/obj/structure/table/woodentable,
/obj/spawner/rations,
/turf/simulated/floor/grass,
/area/deepmaint)
"f" = (
/obj/structure/table/woodentable,
/obj/spawner/rations,
/obj/spawner/rations,
/obj/spawner/rations,
/turf/simulated/floor/grass,
/area/deepmaint)
"g" = (
/obj/machinery/portable_atmospherics/hydroponics,
/turf/simulated/floor/dirt,
/area/deepmaint)
"h" = (
/obj/machinery/portable_atmospherics/hydroponics,
/turf/simulated/floor/grass,
/area/deepmaint)
"i" = (
/obj/structure/table/woodentable,
/obj/spawner/pack/rare,
/obj/spawner/pack/gun_loot/low_chance,
/obj/spawner/pack/gun_loot/low_chance,
/obj/spawner/pack/gun_loot/low_chance,
/turf/simulated/floor/grass,
/area/deepmaint)
"j" = (
/obj/structure/table/woodentable,
/obj/spawner/pack/rare/low_chance,
/obj/spawner/pack/rare/low_chance,
/turf/simulated/floor/grass,
/area/deepmaint)
"k" = (
/turf/simulated/floor/grass,
/area/deepmaint)
"l" = (
/turf/simulated/floor/dirt,
/area/deepmaint)
"m" = (
/turf/simulated/floor/wood,
/area/deepmaint)
"n" = (
/turf/simulated/floor/tiled/steel/cargo,
/area/deepmaint)
"o" = (
/obj/machinery/door/airlock/glass{
	name = "Hydroponics";
	req_access = list(35)
	},
/turf/simulated/floor/wood,
/area/deepmaint)
"p" = (
/turf/simulated/floor/tiled/steel/panels,
/area/deepmaint)
"q" = (
/obj/spawner/traps/low_chance,
/turf/simulated/floor/tiled/steel/panels,
/area/deepmaint)
"r" = (
/obj/structure/table/woodentable,
/obj/spawner/pack/tech_loot,
/obj/spawner/pack/tech_loot,
/obj/spawner/pack/tech_loot/low_chance,
/obj/spawner/pack/tech_loot/low_chance,
/turf/simulated/floor/grass,
/area/deepmaint)
"s" = (
/obj/structure/table/woodentable,
/obj/spawner/pack/tech_loot,
/obj/spawner/pack/tech_loot,
/obj/spawner/pack/tech_loot/low_chance,
/obj/spawner/pack/tech_loot/low_chance,
/turf/simulated/floor/dirt,
/area/deepmaint)
"t" = (
/obj/machinery/light/small,
/turf/simulated/floor/wood,
/area/deepmaint)
"u" = (
/obj/machinery/light/small{
	dir = 1
	},
/turf/simulated/floor/wood,
/area/deepmaint)

(1,1,1) = {"
a
a
d
a
n
n
n
a
a
a
a
"}
(2,1,1) = {"
a
b
c
c
b
p
b
c
c
b
a
"}
(3,1,1) = {"
a
c
e
k
c
q
c
r
s
c
a
"}
(4,1,1) = {"
a
c
f
l
c
p
c
k
r
c
a
"}
(5,1,1) = {"
a
c
g
t
b
q
b
u
h
c
a
"}
(6,1,1) = {"
a
c
h
m
o
p
o
m
h
c
a
"}
(7,1,1) = {"
a
c
h
t
b
q
b
u
g
c
a
"}
(8,1,1) = {"
a
c
i
k
c
p
c
k
r
c
a
"}
(9,1,1) = {"
a
c
j
k
c
p
c
r
r
c
a
"}
(10,1,1) = {"
a
b
c
c
b
q
b
c
c
b
a
"}
(11,1,1) = {"
a
a
a
a
n
n
n
a
d
a
a
"}
