"a" = (/turf/simulated/floor/tiled/steel/brown_perforated,/area/deepmaint)
"b" = (/obj/machinery/light/small,/turf/simulated/floor/tiled/steel/brown_perforated,/area/deepmaint)
"c" = (/turf/simulated/wall,/area/deepmaint)
"d" = (/turf/simulated/floor/tiled/steel/cargo,/area/deepmaint)
"e" = (/obj/machinery/mech_recharger,/obj/random/exosuit/low_chance,/turf/simulated/floor/tiled/steel,/area/deepmaint)
"f" = (/obj/machinery/light/small{dir = 1},/turf/simulated/floor/tiled/steel/cargo,/area/deepmaint)
"g" = (/obj/random/traps/low_chance,/turf/simulated/floor/tiled/steel/cargo,/area/deepmaint)
"h" = (/turf/simulated/floor/tiled/steel/gray_platform,/area/deepmaint)
"i" = (/obj/random/pack/machine,/turf/simulated/floor/tiled/steel/gray_platform,/area/deepmaint)
"j" = (/obj/structure/table/standard{name = "plastic table frame"},/obj/random/powercell,/obj/random/powercell,/obj/random/powercell,/turf/simulated/floor/tiled/steel/gray_platform,/area/deepmaint)
"k" = (/obj/structure/reagent_dispensers/fueltank,/turf/simulated/floor/tiled/steel/gray_platform,/area/deepmaint)
"l" = (/obj/structure/table/standard{name = "plastic table frame"},/obj/random/pack/rare/low_chance,/turf/simulated/floor/tiled/steel/gray_platform,/area/deepmaint)
"m" = (/obj/random/cluster/roaches/low_chance,/obj/machinery/repair_station,/turf/simulated/floor/tiled/steel/gray_platform,/area/deepmaint)
"n" = (/obj/machinery/recharge_station,/turf/simulated/floor/tiled/steel/gray_platform,/area/deepmaint)
"o" = (/obj/structure/table/standard{name = "plastic table frame"},/obj/item/weapon/storage/toolbox/mechanical,/turf/simulated/floor/tiled/steel/gray_platform,/area/deepmaint)
"p" = (/obj/structure/reagent_dispensers/fueltank,/obj/machinery/light/small{dir = 1},/turf/simulated/floor/tiled/steel/gray_platform,/area/deepmaint)
"q" = (/obj/structure/table/standard{name = "plastic table frame"},/obj/random/pack/tech_loot,/obj/random/pack/tech_loot,/obj/random/pack/tech_loot/low_chance,/obj/random/pack/tech_loot/low_chance,/turf/simulated/floor/tiled/steel/gray_platform,/area/deepmaint)
"r" = (/obj/machinery/mech_recharger,/obj/random/exosuit/damaged,/turf/simulated/floor/tiled/steel,/area/deepmaint)
"s" = (/obj/machinery/light/small{dir = 1},/turf/simulated/floor/tiled/steel/brown_perforated,/area/deepmaint)
"t" = (/obj/random/junk,/turf/simulated/floor/tiled/steel/brown_perforated,/area/deepmaint)
"u" = (/obj/machinery/door/airlock/maintenance_common{name = "Service Maintenance"; req_access = list(12)},/turf/simulated/floor/tiled/steel/cargo,/area/deepmaint)
"v" = (/obj/random/junk,/turf/simulated/floor/tiled/steel/cargo,/area/deepmaint)
"w" = (/obj/random/junk,/turf/simulated/floor/tiled/steel/gray_platform,/area/deepmaint)
"x" = (/obj/random/junk,/obj/random/junk,/turf/simulated/floor/tiled/steel/brown_perforated,/area/deepmaint)

(1,1,1) = {"
taaababatat
accccucccca
aceecvceeca
afddgdgddfa
twhijklihha
ahmncccnmha
ahhiopqihha
advdgdgdddt
aceecdcerct
xccccucccca
ttttsasatxt
"}
