"a" = (/turf/simulated/floor/tiled/white/brown_platform,/area/deepmaint)
"b" = (/obj/structure/table/standard,/obj/random/medical,/obj/random/medical,/obj/random/medical,/obj/random/medical/low_chance,/obj/random/medical/low_chance,/obj/random/medical/low_chance,/turf/simulated/floor/tiled/white/brown_perforated,/area/deepmaint)
"c" = (/obj/structure/closet/crate/freezer,/obj/random/pack/rare/low_chance,/turf/simulated/floor/tiled/white/brown_perforated,/area/deepmaint)
"d" = (/obj/structure/table/standard,/obj/random/surgery_tool,/obj/random/surgery_tool/low_chance,/turf/simulated/floor/tiled/white/brown_perforated,/area/deepmaint)
"e" = (/obj/structure/table/standard,/obj/random/lowkeyrandom,/obj/random/lowkeyrandom,/turf/simulated/floor/tiled/white/brown_perforated,/area/deepmaint)
"f" = (/obj/random/medical_lowcost,/turf/simulated/floor/tiled/white/brown_platform,/area/deepmaint)
"g" = (/obj/random/medical/low_chance,/turf/simulated/floor/tiled/white/brown_platform,/area/deepmaint)
"h" = (/turf/simulated/wall,/area/deepmaint)
"i" = (/obj/effect/window_lwall_spawn/smartspawn,/turf/simulated/floor/plating,/area/deepmaint)
"j" = (/mob/living/bot/medbot{on = 0},/turf/simulated/floor/tiled/white/brown_platform,/area/deepmaint)
"k" = (/obj/structure/table/standard,/obj/random/surgery_tool,/obj/random/surgery_tool/low_chance,/turf/simulated/floor/tiled/white/panels,/area/deepmaint)
"l" = (/obj/machinery/optable,/turf/simulated/floor/tiled/white/panels,/area/deepmaint)
"m" = (/turf/simulated/floor/tiled/white/panels,/area/deepmaint)
"n" = (/obj/random/cluster/roaches/low_chance,/turf/simulated/floor/tiled/white/brown_platform,/area/deepmaint)
"o" = (/turf/simulated/floor/tiled/steel/techfloor_grid,/area/deepmaint)
"p" = (/obj/structure/table/standard,/turf/simulated/floor/tiled/white/brown_perforated,/area/deepmaint)
"q" = (/obj/structure/medical_stand,/turf/simulated/floor/tiled/white/brown_perforated,/area/deepmaint)
"r" = (/turf/simulated/floor/tiled/white/brown_perforated,/area/deepmaint)
"s" = (/obj/machinery/light/small{dir = 1},/turf/simulated/floor/tiled/white/brown_platform,/area/deepmaint)

(1,1,1) = {"
aaaaaaaaaaa
ahbbbcdeeha
ahiiiiiiiha
aafgaajaaaa
aafaanaaaaa
ahiiiaiiiha
ahkliailkha
ahmmiaimmha
ahhohahohha
apqrsnsrqpa
aaaaaaaaaaa
"}
