//MAP CONVERTED BY dmm2tgm.py THIS HEADER COMMENT PREVENTS RECONVERSION, DO NOT REMOVE
"a" = (
/turf/simulated/floor/tiled/dark,
/area/deepmaint)
"b" = (
/obj/machinery/light/small,
/turf/simulated/floor/tiled/dark,
/area/deepmaint)
"c" = (
/turf/simulated/wall,
/area/deepmaint)
"d" = (
/obj/structure/table/rack,
/obj/spawner/pack/tech_loot/low_chance,
/obj/spawner/pack/tech_loot/low_chance,
/obj/spawner/pack/tech_loot/low_chance,
/obj/spawner/pack/tech_loot/low_chance,
/turf/simulated/floor/tiled/dark/gray_perforated,
/area/deepmaint)
"e" = (
/obj/structure/table/rack,
/obj/spawner/pack/gun_loot/low_chance,
/obj/spawner/pack/gun_loot/low_chance,
/turf/simulated/floor/tiled/dark/gray_perforated,
/area/deepmaint)
"f" = (
/obj/structure/table/rack/shelf,
/obj/spawner/pack/cloth,
/obj/spawner/pack/cloth,
/obj/spawner/pack/cloth,
/obj/spawner/pack/cloth/low_chance,
/obj/spawner/pack/cloth/low_chance,
/turf/simulated/floor/tiled/dark/gray_perforated,
/area/deepmaint)
"g" = (
/turf/simulated/floor/tiled/dark/techfloor_grid,
/area/deepmaint)
"h" = (
/obj/machinery/door/firedoor,
/obj/effect/window_lwall_spawn/smartspawn,
/turf/simulated/floor/plating,
/area/deepmaint)
"i" = (
/obj/machinery/light/small{
	dir = 1
	},
/turf/simulated/floor/tiled/dark/panels,
/area/deepmaint)
"j" = (
/obj/structure/morgue{
	icon_state = "morgue1";
	dir = 8
	},
/turf/simulated/floor/tiled/dark/panels,
/area/deepmaint)
"k" = (
/turf/simulated/floor/tiled/dark/panels,
/area/deepmaint)
"l" = (
/obj/machinery/light/small{
	dir = 8
	},
/turf/simulated/floor/tiled/dark,
/area/deepmaint)
"m" = (
/obj/structure/table/standard,
/obj/item/weapon/autopsy_scanner{
	pixel_x = 1;
	pixel_y = 1
	},
/obj/item/weapon/tool/scalpel,
/obj/item/weapon/tool/cautery{
	pixel_y = 4
	},
/turf/simulated/floor/tiled/dark/panels,
/area/deepmaint)
"n" = (
/obj/machinery/optable,
/turf/simulated/floor/tiled/dark/panels,
/area/deepmaint)
"o" = (
/obj/machinery/light/small{
	dir = 4;
	pixel_y = 0
	},
/turf/simulated/floor/tiled/dark,
/area/deepmaint)
"p" = (
/obj/machinery/door/airlock/maintenance_common{
	name = "Service Maintenance";
	req_access = list(12)
	},
/turf/simulated/floor/tiled/dark/cargo,
/area/deepmaint)
"q" = (
/obj/machinery/bodyscanner,
/turf/simulated/floor/tiled/dark/panels,
/area/deepmaint)
"r" = (
/obj/machinery/body_scanconsole,
/turf/simulated/floor/tiled/dark/panels,
/area/deepmaint)
"s" = (
/obj/structure/table/rack,
/obj/spawner/medical,
/obj/spawner/medical/low_chance,
/obj/spawner/medical/low_chance,
/turf/simulated/floor/tiled/dark/gray_perforated,
/area/deepmaint)
"t" = (
/obj/machinery/light/small{
	dir = 1
	},
/turf/simulated/floor/tiled/dark,
/area/deepmaint)

(1,1,1) = {"
a
a
a
a
a
a
a
a
a
a
a
"}
(2,1,1) = {"
b
c
c
a
a
c
c
c
c
c
t
"}
(3,1,1) = {"
a
c
f
g
g
h
m
k
q
c
a
"}
(4,1,1) = {"
a
c
f
g
g
h
n
k
r
c
a
"}
(5,1,1) = {"
b
c
c
a
a
c
c
p
c
c
t
"}
(6,1,1) = {"
a
a
a
a
a
a
o
a
a
a
a
"}
(7,1,1) = {"
a
d
c
h
h
h
c
p
c
s
a
"}
(8,1,1) = {"
a
d
c
i
k
k
k
k
c
s
a
"}
(9,1,1) = {"
a
e
c
j
j
j
j
j
c
s
a
"}
(10,1,1) = {"
a
e
c
c
c
c
c
c
c
s
a
"}
(11,1,1) = {"
a
a
a
a
a
l
a
a
a
a
a
"}
