//MAP CONVERTED BY dmm2tgm.py THIS HEADER COMMENT PREVENTS RECONVERSION, DO NOT REMOVE
"a" = (
/turf/simulated/floor/tiled/steel/brown_platform,
/area/deepmaint)
"b" = (
/obj/spawner/traps,
/turf/simulated/floor/tiled/steel/brown_platform,
/area/deepmaint)
"c" = (
/turf/simulated/wall,
/area/deepmaint)
"d" = (
/obj/machinery/door/firedoor,
/obj/effect/window_lwall_spawn/smartspawn,
/turf/simulated/floor/plating,
/area/deepmaint)
"e" = (
/obj/structure/table/standard,
/obj/item/weapon/paper_bin,
/turf/simulated/floor/tiled/steel/gray_perforated,
/area/deepmaint)
"f" = (
/obj/structure/table/standard,
/obj/item/device/lighting/toggleable/lamp,
/turf/simulated/floor/tiled/steel/gray_perforated,
/area/deepmaint)
"g" = (
/obj/structure/reagent_dispensers/water_cooler,
/turf/simulated/floor/tiled/steel/gray_perforated,
/area/deepmaint)
"h" = (
/obj/structure/table/standard,
/obj/spawner/pack/rare/low_chance,
/obj/spawner/lowkeyrandom,
/obj/spawner/lowkeyrandom,
/turf/simulated/floor/tiled/steel/gray_perforated,
/area/deepmaint)
"i" = (
/obj/structure/bed/chair/office/dark{
	dir = 1
	},
/turf/simulated/floor/tiled/steel/gray_perforated,
/area/deepmaint)
"j" = (
/obj/structure/bed/chair/office/dark{
	dir = 4
	},
/turf/simulated/floor/tiled/steel/gray_perforated,
/area/deepmaint)
"k" = (
/obj/structure/table/standard,
/obj/spawner/pack/gun_loot/low_chance,
/turf/simulated/floor/tiled/steel/gray_perforated,
/area/deepmaint)
"l" = (
/turf/simulated/floor/tiled/steel/gray_perforated,
/area/deepmaint)
"m" = (
/obj/structure/table/standard,
/obj/spawner/powercell/low_chance,
/turf/simulated/floor/tiled/steel/gray_perforated,
/area/deepmaint)
"n" = (
/turf/simulated/floor/tiled/steel/gray_platform,
/area/deepmaint)
"o" = (
/obj/spawner/traps,
/turf/simulated/floor/tiled/steel/gray_platform,
/area/deepmaint)
"p" = (
/obj/structure/bed/chair/office/dark,
/turf/simulated/floor/tiled/steel/gray_perforated,
/area/deepmaint)
"q" = (
/obj/spawner/mob/roaches/cluster/low_chance,
/turf/simulated/floor/tiled/steel/gray_platform,
/area/deepmaint)
"r" = (
/obj/machinery/light/small{
	dir = 4;
	pixel_y = 0
	},
/turf/simulated/floor/tiled/steel/gray_perforated,
/area/deepmaint)
"s" = (
/obj/machinery/light/small{
	dir = 8
	},
/turf/simulated/floor/tiled/steel/gray_perforated,
/area/deepmaint)

(1,1,1) = {"
a
a
a
a
a
a
a
b
a
a
a
"}
(2,1,1) = {"
b
c
c
c
c
d
c
c
c
c
b
"}
(3,1,1) = {"
a
d
e
h
l
n
l
h
e
d
a
"}
(4,1,1) = {"
a
d
f
i
l
q
r
p
f
d
a
"}
(5,1,1) = {"
a
c
c
c
c
n
c
c
c
c
a
"}
(6,1,1) = {"
a
d
e
h
l
n
l
h
e
d
a
"}
(7,1,1) = {"
a
d
f
i
l
n
r
p
f
d
a
"}
(8,1,1) = {"
a
c
c
c
c
n
c
c
c
c
a
"}
(9,1,1) = {"
a
c
g
j
l
n
s
j
g
c
a
"}
(10,1,1) = {"
a
c
f
k
m
o
m
k
f
c
a
"}
(11,1,1) = {"
a
a
a
a
a
a
a
a
a
a
a
"}
