"a" = (/turf/simulated/floor/tiled/techmaint_panels,/area/deepmaint)
"b" = (/turf/simulated/floor/tiled/techmaint_perforated,/area/deepmaint)
"c" = (/turf/simulated/wall,/area/deepmaint)
"d" = (/obj/random/cluster/roaches/low_chance,/turf/simulated/floor/plating/under,/area/deepmaint)
"e" = (/obj/random/scrap/moderate_weighted,/turf/simulated/floor/plating/under,/area/deepmaint)
"f" = (/turf/simulated/floor/plating/under,/area/deepmaint)
"g" = (/obj/random/pack/machine,/turf/simulated/floor/tiled/techmaint_cargo,/area/deepmaint)
"h" = (/obj/effect/window_lwall_spawn/smartspawn,/turf/simulated/floor/plating,/area/deepmaint)
"i" = (/obj/structure/table/standard,/obj/random/pack/tech_loot,/obj/random/pack/tech_loot,/obj/random/pack/tech_loot,/obj/random/pack/tech_loot,/obj/random/pack/tech_loot/low_chance,/obj/random/pack/tech_loot/low_chance,/turf/simulated/floor/tiled/white/brown_perforated,/area/deepmaint)
"j" = (/turf/simulated/floor/tiled/techmaint_cargo,/area/deepmaint)
"k" = (/obj/structure/table/standard,/obj/random/pack/rare,/obj/random/pack/rare,/obj/random/pack/rare,/obj/random/pack/rare/low_chance,/turf/simulated/floor/tiled/white/brown_perforated,/area/deepmaint)
"l" = (/obj/structure/railing{tag = "icon-railing0 (WEST)"; icon_state = "railing0"; dir = 8},/turf/simulated/floor/plating/under,/area/deepmaint)
"m" = (/obj/structure/table/standard,/obj/random/pack/gun_loot,/obj/random/pack/gun_loot/low_chance,/obj/random/pack/gun_loot/low_chance,/obj/random/pack/gun_loot/low_chance,/turf/simulated/floor/tiled/white/brown_perforated,/area/deepmaint)
"n" = (/obj/structure/railing{tag = "icon-railing0 (EAST)"; icon_state = "railing0"; dir = 4},/turf/simulated/floor/plating/under,/area/deepmaint)
"o" = (/obj/structure/railing{tag = "icon-railing0 (WEST)"; icon_state = "railing0"; dir = 8},/obj/structure/railing,/turf/simulated/floor/plating/under,/area/deepmaint)
"p" = (/obj/structure/railing,/turf/simulated/floor/plating/under,/area/deepmaint)
"q" = (/obj/machinery/door/airlock/maintenance_common{name = "Service Maintenance"; req_access = list(12)},/turf/simulated/floor/tiled/techmaint_cargo,/area/deepmaint)
"r" = (/obj/structure/railing,/obj/structure/railing{tag = "icon-railing0 (EAST)"; icon_state = "railing0"; dir = 4},/turf/simulated/floor/plating/under,/area/deepmaint)
"s" = (/obj/random/cluster/roaches/low_chance,/turf/simulated/floor/tiled/techmaint_panels,/area/deepmaint)
"t" = (/obj/random/cluster/roaches,/turf/simulated/floor/tiled/techmaint_cargo,/area/deepmaint)
"u" = (/obj/random/cluster/roaches/low_chance,/turf/simulated/floor/tiled/techmaint_cargo,/area/deepmaint)
"v" = (/obj/structure/table/standard,/obj/random/pack/tech_loot,/obj/random/pack/tech_loot,/obj/random/pack/tech_loot,/obj/random/pack/tech_loot,/obj/random/pack/tech_loot/low_chance,/obj/random/pack/tech_loot/low_chance,/obj/machinery/light/small{dir = 1},/turf/simulated/floor/tiled/white/brown_perforated,/area/deepmaint)
"w" = (/obj/machinery/light/small{dir = 1},/turf/simulated/floor/tiled/techmaint_panels,/area/deepmaint)

(1,1,1) = {"
bbbbbbbbbbb
bccccaccccb
bcdecfcedcb
bcfecccefcb
bcfccgccfcb
bcfhvjkhfcb
blfhijmhfnb
bopchqhcprb
bsawataaasb
bjjjjujjjjb
bbbbbbbbbbb
"}
