"a" = (/turf/simulated/floor/tiled/dark/danger,/area/deepmaint)
"b" = (/obj/random/junk,/turf/simulated/floor/tiled/dark/danger,/area/deepmaint)
"c" = (/obj/random/cluster/roaches/low_chance,/turf/simulated/floor/tiled/dark/cargo,/area/deepmaint)
"d" = (/turf/simulated/floor/tiled/dark/cargo,/area/deepmaint)
"e" = (/turf/simulated/floor/plating/under,/area/deepmaint)
"f" = (/obj/random/pack/tech_loot/low_chance,/turf/simulated/floor/plating/under,/area/deepmaint)
"g" = (/obj/structure/catwalk,/turf/simulated/floor/plating/under,/area/deepmaint)
"h" = (/obj/random/junk,/turf/simulated/floor/plating/under,/area/deepmaint)
"i" = (/obj/machinery/deployable/barrier,/turf/simulated/floor/plating/under,/area/deepmaint)
"j" = (/obj/structure/girder,/turf/simulated/floor/plating/under,/area/deepmaint)
"k" = (/obj/structure/catwalk,/obj/structure/barricade,/turf/simulated/floor/plating/under,/area/deepmaint)
"l" = (/turf/simulated/wall/r_wall,/area/deepmaint)
"m" = (/obj/effect/window_lwall_spawn/plasma,/obj/machinery/door/blast/regular{_wifi_id = null; icon_state = "pdoor1"; id = null; name = "Reactor Core"; p_open = 0},/turf/simulated/floor/plating,/area/deepmaint)
"n" = (/obj/random/pack/rare,/turf/simulated/floor/reinforced{name = "engine floor"; oxygen = 0},/area/deepmaint)
"o" = (/turf/simulated/floor/reinforced{name = "engine floor"; oxygen = 0},/area/deepmaint)
"p" = (/obj/random/junk,/turf/simulated/floor/tiled/dark/cargo,/area/deepmaint)
"r" = (/obj/effect/window_lwall_spawn/plasma,/obj/machinery/door/blast/regular{_wifi_id = null; icon_state = "pdoor1"; id = null; name = "Reactor Core"; p_open = 0},/turf/simulated/floor/reinforced,/area/deepmaint)
"s" = (/obj/machinery/power/supermatter{layer = 4},/turf/simulated/floor/reinforced{name = "engine floor"; oxygen = 0},/area/deepmaint)
"t" = (/obj/structure/barricade,/turf/simulated/floor/plating/under,/area/deepmaint)
"u" = (/obj/structure/girder/displaced,/turf/simulated/floor/plating/under,/area/deepmaint)
"v" = (/obj/random/cluster/roaches/low_chance,/turf/simulated/floor/tiled/dark/danger,/area/deepmaint)

(1,1,1) = {"
ababcddabab
aeefeghefea
beiijkjjiea
afjllmlljfb
deilnonljhd
pgkrosomkgd
dhjlnonlted
afullmlljfa
bhtjukujjeb
aeffhghfhfa
vabadddbaav
"}
