//MAP CONVERTED BY dmm2tgm.py THIS HEADER COMMENT PREVENTS RECONVERSION, DO NOT REMOVE
"ah" = (
/obj/structure/table/woodentable,
/obj/machinery/microwave,
/turf/floor/tiled/steel/techfloor,
/area/map_template/lodge)
"bF" = (
/obj/structure/toilet{
	dir = 8
	},
/turf/floor/tiled/white,
/area/map_template/lodge)
"ce" = (
/obj/structure/closet/cabinet,
/obj/item/clothing/under/color/black,
/obj/spawner/cloth/shoes,
/obj/item/clothing/mask/breath,
/turf/floor/carpet/turcarpet,
/area/map_template/lodge)
"dO" = (
/obj/spawner/junk/low_chance,
/turf/floor/wood,
/area/map_template/lodge)
"fz" = (
/obj/structure/table/standard,
/obj/spawner/medical_lowcost,
/turf/floor/tiled/white,
/area/map_template/lodge)
"im" = (
/obj/structure/table/woodentable,
/obj/effect/floor_decal/spline/fancy/wood/corner{
	dir = 1
	},
/obj/spawner/booze/low_chance,
/obj/machinery/light{
	dir = 8
	},
/turf/floor/tiled/steel/techfloor,
/area/map_template/lodge)
"iR" = (
/turf/floor/wood,
/area/map_template/lodge)
"lg" = (
/obj/structure/closet/crate/freezer,
/obj/effect/floor_decal/spline/fancy/wood{
	dir = 4
	},
/obj/spawner/junkfood,
/obj/spawner/junkfood,
/turf/floor/tiled/steel/techfloor,
/area/map_template/lodge)
"lX" = (
/obj/machinery/door/unpowered/simple/wood,
/turf/floor/tiled/white,
/area/map_template/lodge)
"mc" = (
/obj/structure/table/woodentable,
/obj/item/device/lighting/toggleable/lamp,
/obj/effect/floor_decal/spline/fancy/wood{
	dir = 4
	},
/turf/floor/tiled/steel/techfloor,
/area/map_template/lodge)
"mn" = (
/obj/structure/table/rack,
/obj/item/gun/projectile/shotgun/doublebarrel/sawn,
/obj/spawner/ammo/shotgun,
/turf/floor/carpet/turcarpet,
/area/map_template/lodge)
"ny" = (
/obj/spawner/medical_lowcost/low_chance,
/turf/floor/tiled/white,
/area/map_template/lodge)
"qb" = (
/obj/structure/computerframe{
	anchored = 1;
	dir = 4
	},
/turf/floor/carpet/turcarpet,
/area/map_template/lodge)
"qq" = (
/obj/structure/table/woodentable,
/obj/item/reagent_containers/food/drinks/bottle/small/beer{
	pixel_x = 2;
	pixel_y = -2
	},
/obj/item/reagent_containers/food/drinks/bottle/small/beer{
	pixel_x = -6;
	pixel_y = 5
	},
/turf/floor/carpet/turcarpet,
/area/map_template/lodge)
"qK" = (
/obj/structure/sink{
	dir = 4;
	pixel_x = 11
	},
/obj/structure/mirror{
	dir = 8;
	pixel_x = 28
	},
/turf/floor/tiled/white,
/area/map_template/lodge)
"sB" = (
/obj/structure/table/woodentable,
/obj/item/paper_bin,
/obj/item/pen,
/turf/floor/carpet/turcarpet,
/area/map_template/lodge)
"uE" = (
/obj/structure/closet,
/obj/item/stack/material/steel{
	amount = 10
	},
/obj/item/stack/material/wood{
	amount = 50
	},
/obj/item/stack/tile/carpet/turcarpet{
	amount = 50
	},
/obj/item/stack/material/glass/reinforced{
	amount = 10
	},
/turf/floor/wood,
/area/map_template/lodge)
"uX" = (
/obj/machinery/portable_atmospherics/hydroponics/soil,
/turf/template_noop,
/area/template_noop)
"ve" = (
/obj/machinery/shower{
	dir = 4
	},
/obj/machinery/door/window/eastright{
	base_state = "left";
	icon_state = "left";
	name = "Shower"
	},
/obj/item/bikehorn/rubberducky,
/obj/structure/window/reinforced,
/turf/floor/tiled/white,
/area/map_template/lodge)
"wU" = (
/mob/living/simple_animal/hostile/roomba/gun_ba,
/turf/floor/wood,
/area/map_template/lodge)
"xm" = (
/obj/structure/bed/chair/comfy/brown{
	dir = 4
	},
/obj/machinery/light,
/turf/floor/wood,
/area/map_template/lodge)
"Ag" = (
/obj/effect/floor_decal/spline/fancy/wood{
	dir = 5
	},
/obj/spawner/junkfood/rotten,
/turf/floor/tiled/steel/techfloor,
/area/map_template/lodge)
"Bi" = (
/obj/spawner/junk/low_chance,
/turf/floor/carpet/turcarpet,
/area/map_template/lodge)
"Cp" = (
/turf/floor/tiled/white/techfloor_grid,
/area/map_template/lodge)
"Fh" = (
/obj/structure/table/woodentable,
/obj/item/folder/blue,
/obj/machinery/light,
/turf/floor/carpet/turcarpet,
/area/map_template/lodge)
"FX" = (
/obj/structure/table/standard,
/obj/item/soap/deluxe,
/obj/machinery/light{
	dir = 8
	},
/turf/floor/tiled/white,
/area/map_template/lodge)
"HH" = (
/turf/floor/carpet/turcarpet,
/area/map_template/lodge)
"Iz" = (
/obj/structure/bed,
/obj/item/bedsheet,
/turf/floor/carpet/turcarpet,
/area/map_template/lodge)
"Jv" = (
/obj/effect/floor_decal/spline/fancy/wood{
	dir = 1
	},
/obj/spawner/junkfood/rotten,
/turf/floor/tiled/steel/techfloor,
/area/map_template/lodge)
"JF" = (
/obj/machinery/power/port_gen/pacman,
/turf/floor/wood,
/area/map_template/lodge)
"Nr" = (
/turf/wall/low/with_glass/reinforced,
/area/map_template/lodge)
"NT" = (
/obj/structure/filingcabinet,
/turf/floor/carpet/turcarpet,
/area/map_template/lodge)
"NU" = (
/obj/structure/table/woodentable,
/obj/effect/decal/cleanable/blood/drip,
/obj/effect/decal/cleanable/blood/drip,
/obj/effect/decal/cleanable/blood/drip,
/obj/item/tool/knife/butch,
/obj/spawner/booze/low_chance,
/turf/floor/tiled/steel/techfloor,
/area/map_template/lodge)
"Om" = (
/turf/template_noop,
/area/template_noop)
"OA" = (
/mob/living/simple_animal/hostile/roomba/boomba,
/turf/floor/tiled/white,
/area/map_template/lodge)
"OH" = (
/obj/machinery/portable_atmospherics/powered/scrubber,
/turf/floor/wood,
/area/map_template/lodge)
"OW" = (
/obj/item/device/lighting/toggleable/lamp/green,
/obj/structure/table/woodentable,
/turf/floor/carpet/turcarpet,
/area/map_template/lodge)
"PB" = (
/mob/living/simple_animal/hostile/roomba/slayer,
/turf/floor/wood,
/area/map_template/lodge)
"Qu" = (
/mob/living/simple_animal/hostile/roomba/slayer,
/turf/floor/carpet/turcarpet,
/area/map_template/lodge)
"RF" = (
/obj/machinery/door/unpowered/simple/wood,
/turf/floor/wood,
/area/map_template/lodge)
"RM" = (
/obj/structure/bed/chair/comfy/brown{
	dir = 8
	},
/turf/floor/carpet/turcarpet,
/area/map_template/lodge)
"Sf" = (
/obj/effect/decal/cleanable/dirt,
/turf/floor/wood,
/area/map_template/lodge)
"Si" = (
/obj/machinery/portable_atmospherics/hydroponics/soil,
/obj/item/seeds/potatoseed,
/turf/template_noop,
/area/template_noop)
"Uy" = (
/obj/structure/table/woodentable,
/obj/item/board,
/turf/floor/wood,
/area/map_template/lodge)
"VI" = (
/obj/structure/table/woodentable,
/obj/item/clothing/mask/smokable/pipe/cobpipe,
/obj/machinery/light{
	dir = 4
	},
/turf/floor/carpet/turcarpet,
/area/map_template/lodge)
"WX" = (
/obj/structure/table/rack,
/obj/effect/decal/cleanable/dirt,
/obj/spawner/pack/tech_loot,
/obj/spawner/pack/tech_loot,
/obj/spawner/pack/tech_loot,
/turf/floor/wood,
/area/map_template/lodge)
"Yu" = (
/turf/wall,
/area/map_template/lodge)

(1,1,1) = {"
Om
Yu
Yu
Nr
Yu
Yu
Yu
Yu
Yu
Yu
Om
"}
(2,1,1) = {"
Om
Yu
ve
FX
fz
Yu
lg
im
ah
Yu
Om
"}
(3,1,1) = {"
Om
Nr
Cp
ny
OA
lX
Sf
Jv
NU
Nr
Om
"}
(4,1,1) = {"
Om
Yu
bF
qK
ny
Yu
wU
Ag
mc
Nr
Om
"}
(5,1,1) = {"
Om
Yu
Yu
Yu
Yu
Yu
Sf
iR
OH
Nr
Om
"}
(6,1,1) = {"
Om
uX
Om
Si
Om
Nr
dO
PB
WX
Yu
Om
"}
(7,1,1) = {"
Om
uX
Om
uX
Om
Nr
iR
Sf
iR
Yu
Om
"}
(8,1,1) = {"
Om
Om
Om
Om
Om
RF
Sf
dO
Sf
RF
Om
"}
(9,1,1) = {"
Om
uX
Om
uX
Om
Yu
uE
PB
xm
Yu
Om
"}
(10,1,1) = {"
Om
Si
Om
uX
Om
Yu
JF
Sf
Uy
Yu
Om
"}
(11,1,1) = {"
Om
Yu
Yu
Nr
Yu
Yu
Yu
RF
Yu
Yu
Om
"}
(12,1,1) = {"
Om
Yu
ce
OW
Bi
HH
Qu
HH
NT
Yu
Om
"}
(13,1,1) = {"
Om
Nr
HH
Qu
HH
HH
sB
qb
Fh
Yu
Om
"}
(14,1,1) = {"
Om
Yu
Iz
VI
mn
HH
Bi
RM
qq
Yu
Om
"}
(15,1,1) = {"
Om
Yu
Yu
Yu
Nr
Nr
Nr
Yu
Yu
Yu
Om
"}
(16,1,1) = {"
Om
Om
Om
Om
Om
Om
Om
Om
Om
Om
Om
"}
