//MAP CONVERTED BY dmm2tgm.py THIS HEADER COMMENT PREVENTS RECONVERSION, DO NOT REMOVE
"a" = (
/turf/template_noop,
/area/template_noop)
"b" = (
/turf/wall,
/area/map_template/lodge)
"c" = (
/obj/machinery/power/port_gen/pacman,
/turf/floor/wood,
/area/map_template/lodge)
"d" = (
/obj/structure/closet/cabinet,
/obj/item/clothing/under/color/black,
/obj/spawner/cloth/shoes,
/obj/item/clothing/mask/breath,
/turf/floor/carpet/turcarpet,
/area/map_template/lodge)
"e" = (
/turf/floor/carpet/turcarpet,
/area/map_template/lodge)
"f" = (
/obj/structure/bed,
/obj/item/bedsheet,
/mob/living/simple_animal/hostile/roomba/slayer,
/turf/floor/carpet/turcarpet,
/area/map_template/lodge)
"g" = (
/turf/wall/low/with_glass/reinforced,
/area/map_template/lodge)
"h" = (
/obj/structure/table/woodentable,
/obj/item/board,
/turf/floor/wood,
/area/map_template/lodge)
"i" = (
/obj/item/device/lighting/toggleable/lamp/green,
/obj/structure/table/woodentable,
/turf/floor/carpet/turcarpet,
/area/map_template/lodge)
"j" = (
/obj/structure/table/woodentable,
/obj/item/clothing/mask/smokable/pipe/cobpipe,
/turf/floor/carpet/turcarpet,
/area/map_template/lodge)
"k" = (
/obj/structure/table/woodentable,
/obj/item/material/kitchen/utensil/fork/plastic,
/obj/item/material/kitchen/utensil/fork/plastic,
/obj/item/material/kitchen/utensil/fork/plastic,
/obj/item/tool/knife,
/obj/effect/floor_decal/spline/fancy/wood/corner{
	dir = 1
	},
/turf/floor/tiled/steel/techfloor,
/area/map_template/lodge)
"l" = (
/obj/structure/table/woodentable,
/obj/item/tool/knife,
/obj/item/tool/knife,
/obj/effect/floor_decal/spline/fancy/wood{
	icon_state = "spline_fancy";
	dir = 1
	},
/turf/floor/tiled/steel/techfloor,
/area/map_template/lodge)
"m" = (
/obj/structure/closet/crate/freezer,
/obj/effect/floor_decal/spline/fancy/wood{
	icon_state = "spline_fancy";
	dir = 1
	},
/turf/floor/tiled/steel/techfloor,
/area/map_template/lodge)
"n" = (
/obj/structure/table/woodentable,
/obj/machinery/microwave,
/obj/effect/floor_decal/spline/fancy/wood{
	dir = 4
	},
/obj/effect/floor_decal/spline/fancy/wood/corner{
	dir = 4
	},
/turf/floor/tiled/steel/techfloor,
/area/map_template/lodge)
"o" = (
/turf/floor/wood,
/area/map_template/lodge)
"p" = (
/obj/structure/bed/chair/wood{
	icon_state = "wooden_chair_preview";
	dir = 8
	},
/obj/effect/floor_decal/spline/fancy/wood/corner,
/turf/floor/wood,
/area/map_template/lodge)
"q" = (
/obj/structure/table/woodentable,
/obj/item/paper_bin,
/obj/item/deck/cards,
/turf/floor/wood,
/area/map_template/lodge)
"r" = (
/obj/effect/floor_decal/spline/fancy/wood{
	icon_state = "spline_fancy";
	dir = 1
	},
/turf/floor/wood,
/area/map_template/lodge)
"s" = (
/obj/structure/table/woodentable,
/obj/effect/decal/cleanable/blood/drip,
/obj/effect/decal/cleanable/blood/drip,
/obj/effect/decal/cleanable/blood/drip,
/obj/item/tool/knife/butch,
/turf/floor/tiled/steel/techfloor,
/area/map_template/lodge)
"t" = (
/turf/floor/tiled/steel/techfloor,
/area/map_template/lodge)
"u" = (
/obj/effect/floor_decal/spline/fancy/wood{
	dir = 4
	},
/turf/floor/tiled/steel/techfloor,
/area/map_template/lodge)
"v" = (
/obj/machinery/r_n_d/server/robotics{
	desc = "A jury-rigged server setup.";
	name = "low-tech server"
	},
/turf/floor/tiled/steel/techfloor,
/area/map_template/lodge)
"w" = (
/mob/living/simple_animal/hostile/roomba/slayer,
/turf/floor/wood,
/area/map_template/lodge)
"x" = (
/obj/structure/table/woodentable,
/obj/item/device/lighting/toggleable/lamp,
/obj/effect/floor_decal/spline/fancy/wood,
/turf/floor/tiled/steel/techfloor,
/area/map_template/lodge)
"y" = (
/obj/effect/floor_decal/spline/fancy/wood,
/turf/floor/tiled/steel/techfloor,
/area/map_template/lodge)
"z" = (
/obj/effect/floor_decal/spline/fancy/wood{
	dir = 6
	},
/turf/floor/tiled/steel/techfloor,
/area/map_template/lodge)
"A" = (
/obj/effect/floor_decal/spline/fancy/wood{
	dir = 4
	},
/turf/floor/wood,
/area/map_template/lodge)
"B" = (
/obj/effect/floor_decal/spline/fancy/wood/corner{
	dir = 1
	},
/turf/floor/wood,
/area/map_template/lodge)
"C" = (
/obj/structure/table/woodentable,
/obj/machinery/computer/atmoscontrol/laptop{
	desc = "A cheap, beat-up old laptop.";
	name = "old laptop"
	},
/turf/floor/tiled/steel/techfloor,
/area/map_template/lodge)
"D" = (
/obj/structure/bed/chair/wood{
	icon_state = "wooden_chair_preview";
	dir = 8
	},
/obj/effect/floor_decal/spline/fancy/wood{
	dir = 4
	},
/turf/floor/tiled/steel/techfloor,
/area/map_template/lodge)
"E" = (
/obj/effect/floor_decal/spline/fancy/wood/corner,
/obj/effect/decal/cleanable/dirt,
/turf/floor/wood,
/area/map_template/lodge)
"F" = (
/obj/effect/floor_decal/spline/fancy/wood,
/turf/floor/wood,
/area/map_template/lodge)
"G" = (
/obj/effect/floor_decal/spline/fancy/wood/corner{
	dir = 8
	},
/turf/floor/wood,
/area/map_template/lodge)
"H" = (
/obj/machinery/door/unpowered/simple/wood,
/turf/floor/wood,
/area/map_template/lodge)
"I" = (
/obj/structure/table/rack,
/obj/item/gun/projectile/shotgun/doublebarrel/sawn,
/obj/spawner/ammo/shotgun,
/turf/floor/wood,
/area/map_template/lodge)
"J" = (
/obj/structure/closet,
/obj/item/stack/material/steel{
	amount = 10
	},
/obj/item/stack/material/wood{
	amount = 50
	},
/obj/item/stack/tile/carpet/turcarpet{
	amount = 50
	},
/obj/item/stack/material/glass/reinforced{
	amount = 10
	},
/obj/effect/floor_decal/spline/fancy/wood/corner{
	dir = 8
	},
/turf/floor/wood,
/area/map_template/lodge)
"L" = (
/obj/machinery/portable_atmospherics/hydroponics/soil,
/obj/item/seeds/towermycelium,
/turf/template_noop,
/area/template_noop)
"M" = (
/obj/machinery/portable_atmospherics/hydroponics/soil,
/obj/item/seeds/potatoseed,
/turf/template_noop,
/area/template_noop)
"N" = (
/obj/effect/floor_decal/spline/fancy/wood/corner,
/turf/floor/wood,
/area/map_template/lodge)
"O" = (
/obj/machinery/portable_atmospherics/hydroponics/soil,
/obj/item/seeds/wheatseed,
/turf/template_noop,
/area/template_noop)
"P" = (
/obj/machinery/portable_atmospherics/hydroponics/soil,
/obj/item/seeds/random,
/turf/template_noop,
/area/template_noop)
"Q" = (
/obj/machinery/portable_atmospherics/powered/scrubber,
/turf/floor/wood,
/area/map_template/lodge)
"S" = (
/obj/machinery/portable_atmospherics/powered/scrubber,
/obj/effect/floor_decal/spline/fancy/wood/corner,
/turf/floor/wood,
/area/map_template/lodge)
"U" = (
/obj/structure/window/reinforced/full,
/turf/wall/low/with_glass/reinforced,
/area/map_template/lodge)
"V" = (
/obj/effect/floor_decal/spline/fancy/wood/corner{
	dir = 8
	},
/obj/effect/decal/cleanable/dirt,
/turf/floor/wood,
/area/map_template/lodge)
"Y" = (
/obj/effect/decal/cleanable/dirt,
/turf/floor/wood,
/area/map_template/lodge)

(1,1,1) = {"
a
a
a
b
b
b
b
a
a
a
a
"}
(2,1,1) = {"
a
a
a
b
v
C
b
a
a
a
a
"}
(3,1,1) = {"
b
b
b
b
u
D
b
a
a
a
a
"}
(4,1,1) = {"
b
d
i
r
w
E
b
a
a
a
a
"}
(5,1,1) = {"
b
e
e
r
o
F
g
L
L
a
a
"}
(6,1,1) = {"
b
e
e
r
o
F
g
a
a
a
a
"}
(7,1,1) = {"
b
f
j
r
o
G
b
L
M
a
a
"}
(8,1,1) = {"
b
b
b
b
b
H
b
a
a
a
a
"}
(9,1,1) = {"
a
b
k
s
x
N
b
M
O
a
a
"}
(10,1,1) = {"
a
g
l
t
y
F
g
a
a
a
a
"}
(11,1,1) = {"
a
g
m
t
y
V
b
M
P
a
a
"}
(12,1,1) = {"
a
b
n
u
z
w
b
b
b
b
b
"}
(13,1,1) = {"
a
b
o
o
o
o
o
w
Q
S
b
"}
(14,1,1) = {"
a
b
o
o
h
q
o
Y
o
F
H
"}
(15,1,1) = {"
a
b
c
o
p
A
A
B
I
J
b
"}
(16,1,1) = {"
a
b
b
b
b
g
U
b
b
b
b
"}
