"a" = (/turf/space,/area/template_noop)
"b" = (/obj/structure/lattice,/turf/space,/area/template_noop)
"c" = (/turf/simulated/wall/r_wall,/area/template_noop)
"d" = (/obj/effect/window_lwall_spawn/smartspawn,/turf/simulated/floor/plating,/area/template_noop)

(1,1,1) = {"
aba
dca
bbb
"}
