"aa" = (/turf/simulated/floor/plating,/area/deepmaint)
"ab" = (/obj/spawner/junk,/turf/simulated/floor/plating,/area/deepmaint)
"ac" = (/obj/spawner/junk,/turf/simulated/floor/asteroid,/area/deepmaint)
"ad" = (/obj/spawner/material/ore,/turf/simulated/floor/asteroid,/area/deepmaint)
"ae" = (/obj/spawner/junk,/obj/spawner/junk,/turf/simulated/floor/asteroid,/area/deepmaint)
"af" = (/turf/simulated/floor/asteroid,/area/deepmaint)
"ag" = (/obj/spawner/junk,/obj/spawner/material/ore,/turf/simulated/floor/asteroid,/area/deepmaint)
"ah" = (/turf/simulated/mineral,/area/deepmaint)
"ai" = (/obj/spawner/material/ore,/turf/simulated/floor/plating,/area/deepmaint)
"aj" = (/obj/spawner/junk,/obj/spawner/junk,/turf/simulated/floor/plating,/area/deepmaint)
"ak" = (/turf/simulated/wall,/area/deepmaint)
"al" = (/obj/spawner/junk,/obj/spawner/material/ore,/turf/simulated/floor/plating,/area/deepmaint)
"am" = (/obj/spawner/pack/gun_loot,/obj/spawner/pack/gun_loot,/turf/simulated/floor/plating/under,/area/deepmaint)
"an" = (/turf/simulated/floor/plating/under,/area/deepmaint)
"ao" = (/obj/item/remains/human,/obj/spawner/pack/cloth,/obj/spawner/pack/cloth,/obj/spawner/pack/gun_loot,/turf/simulated/floor/plating/under,/area/deepmaint)
"ap" = (/obj/item/remains/human,/obj/spawner/pack/cloth,/obj/spawner/pack/cloth,/obj/spawner/pack/gun_loot,/turf/simulated/floor/asteroid,/area/deepmaint)
"aq" = (/obj/structure/ore_box,/turf/simulated/floor/asteroid,/area/deepmaint)
"ar" = (/obj/machinery/door/blast/shutters{dir = 2; id = "maint_hatch_maint_asteroid"; layer = 3.3; name = "Maintenance Hatch"},/obj/effect/window_lwall_spawn/smartspawn,/turf/simulated/floor/plating,/area/deepmaint)
"as" = (/obj/item/tool/pickaxe,/turf/simulated/floor/asteroid,/area/deepmaint)
"at" = (/obj/spawner/material/ore,/obj/spawner/material/ore,/turf/simulated/floor/asteroid,/area/deepmaint)
"au" = (/obj/machinery/mining/drill,/turf/simulated/floor/tiled/steel/brown_platform,/area/deepmaint)
"av" = (/obj/machinery/mining/brace,/turf/simulated/floor/tiled/steel/brown_platform,/area/deepmaint)
"aw" = (/obj/machinery/button/remote/blast_door{id = "maint_hatch_maint_asteroid"; name = "Maintenance Hatch Control"; pixel_x = 0; pixel_y = 24; req_access = null},/obj/machinery/mining/brace,/turf/simulated/floor/tiled/steel/brown_platform,/area/deepmaint)
"ax" = (/obj/machinery/mining/brace,/obj/machinery/light{dir = 1},/turf/simulated/floor/tiled/steel/brown_platform,/area/deepmaint)
"ay" = (/obj/machinery/floodlight,/turf/simulated/floor/asteroid,/area/deepmaint)
"az" = (/obj/spawner/mob/biome_spawner_mob/low_chance,/turf/simulated/floor/asteroid,/area/deepmaint)
"aA" = (/turf/simulated/floor/tiled/steel/brown_perforated,/area/deepmaint)
"aB" = (/obj/structure/table/standard,/obj/spawner/pack/tech_loot,/obj/spawner/pack/tech_loot,/obj/spawner/pack/tech_loot/low_chance,/obj/spawner/pack/tech_loot/low_chance,/turf/simulated/floor/tiled/steel/brown_platform,/area/deepmaint)
"aC" = (/obj/spawner/structures/common,/turf/simulated/floor/tiled/steel/gray_platform,/area/deepmaint)
"aD" = (/turf/simulated/floor/tiled/steel,/area/deepmaint)
"aE" = (/turf/simulated/floor/tiled/steel/cargo,/area/deepmaint)
"aF" = (/obj/structure/table/standard,/obj/spawner/pack/tech_loot,/obj/spawner/pack/tech_loot,/obj/spawner/pack/tech_loot/low_chance,/turf/simulated/floor/tiled/steel/gray_platform,/area/deepmaint)
"aG" = (/obj/spawner/mob/biome_spawner_mob/low_chance,/turf/simulated/floor/tiled/steel,/area/deepmaint)
"aH" = (/obj/machinery/door/airlock/multi_tile/glass{dir = 2},/turf/simulated/floor/tiled/steel/cargo,/area/deepmaint)
"aI" = (/obj/spawner/junk,/obj/spawner/material/ore,/obj/spawner/material/ore,/turf/simulated/floor/plating,/area/deepmaint)
"aJ" = (/obj/structure/table/standard,/obj/spawner/pack/tech_loot,/obj/spawner/pack/tech_loot,/obj/spawner/pack/tech_loot/low_chance,/obj/machinery/light{dir = 8},/turf/simulated/floor/tiled/steel/gray_platform,/area/deepmaint)
"aK" = (/obj/machinery/light{icon_state = "tube1"; dir = 4},/turf/simulated/floor/tiled/steel,/area/deepmaint)
"aL" = (/obj/machinery/light{dir = 8},/turf/simulated/floor/asteroid,/area/deepmaint)
"aM" = (/obj/structure/table/standard,/obj/spawner/material/building,/obj/spawner/material/building,/obj/spawner/material/building,/turf/simulated/floor/tiled/steel/gray_platform,/area/deepmaint)
"aN" = (/obj/structure/table/standard,/obj/spawner/material/resources/rare,/obj/spawner/material/resources/rare,/turf/simulated/floor/tiled/steel/gray_platform,/area/deepmaint)
"aO" = (/obj/structure/table/standard,/obj/spawner/material/resources,/obj/spawner/material/resources,/turf/simulated/floor/tiled/steel/gray_platform,/area/deepmaint)
"aP" = (/obj/structure/reagent_dispensers/watertank/huge,/turf/simulated/floor/asteroid,/area/deepmaint)
"aQ" = (/obj/structure/table/woodentable,/obj/item/seeds/ambrosiavulgarisseed,/obj/item/seeds/ambrosiavulgarisseed,/obj/item/seeds/ambrosiavulgarisseed,/turf/simulated/floor/asteroid,/area/deepmaint)
"aR" = (/obj/spawner/material/ore,/turf/simulated/floor/plating/under,/area/deepmaint)
"aS" = (/obj/machinery/door/airlock/multi_tile/glass,/turf/simulated/floor/tiled/steel/cargo,/area/deepmaint)
"aT" = (/obj/machinery/portable_atmospherics/hydroponics,/turf/simulated/floor/asteroid,/area/deepmaint)
"aU" = (/obj/spawner/junk,/obj/spawner/material/ore,/turf/simulated/floor/plating/under,/area/deepmaint)
"aV" = (/obj/structure/closet/cabinet,/obj/spawner/pack/cloth,/obj/spawner/pack/cloth,/obj/spawner/pack/cloth,/obj/spawner/pack/cloth/low_chance,/turf/simulated/floor/carpet,/area/deepmaint)
"aW" = (/obj/structure/closet/cabinet,/obj/spawner/pack/rare,/obj/spawner/pack/rare,/obj/spawner/pack/rare/low_chance,/turf/simulated/floor/carpet,/area/deepmaint)
"aX" = (/obj/structure/table/woodentable,/obj/spawner/pack/gun_loot,/obj/spawner/pack/gun_loot/low_chance,/turf/simulated/floor/carpet,/area/deepmaint)
"aY" = (/turf/simulated/floor/tiled/steel/techfloor_grid,/area/deepmaint)
"aZ" = (/obj/effect/window_lwall_spawn/smartspawn,/turf/simulated/floor/plating,/area/deepmaint)
"ba" = (/turf/simulated/floor/carpet,/area/deepmaint)
"bb" = (/obj/machinery/door/airlock,/turf/simulated/floor/tiled/steel/cargo,/area/deepmaint)
"bc" = (/obj/structure/table/woodentable,/obj/item/device/lighting/toggleable/lamp/green,/turf/simulated/floor/carpet,/area/deepmaint)
"bd" = (/obj/structure/bed/padded,/obj/item/bedsheet,/turf/simulated/floor/carpet,/area/deepmaint)
"be" = (/obj/machinery/light{icon_state = "tube1"; dir = 4},/turf/simulated/floor/carpet,/area/deepmaint)
"bf" = (/obj/machinery/light{dir = 8},/turf/simulated/floor/tiled/steel/techfloor_grid,/area/deepmaint)
"bg" = (/obj/spawner/junk,/turf/simulated/floor/plating/under,/area/deepmaint)
"bh" = (/obj/spawner/junk,/turf/simulated/floor/tiled/techmaint_cargo,/area/deepmaint)
"bi" = (/turf/simulated/floor/tiled/techmaint_cargo,/area/deepmaint)
"bj" = (/obj/landmark/loot_biomes/mob/roach{range = 10},/turf/simulated/floor/tiled/steel,/area/deepmaint)

(1,1,1) = {"
aaaaabaaacacacadacaeafadaaabaaaaaaabaaabaa
aaababagahahahahahahahahacagacaiababaaajaa
ababacahahakakakakakakahahahahadadadadabaa
aaalahahahakamananaoakapafafahaqafadadadab
abaiahahahakakakarakakakakafahahafasatafab
aaabahahahakauauavawaxavakafahahayazadasab
aaabahahahakaAaAaAaAaAaAakafafahahayafadai
aaaiacahahakaBaAaAaAaAaBakakafahahahahaqab
aaalacacahakaCaDaDaDaDaDaDaEafafahahahahaa
abaaazahahakaFaDaDaDaGaDaDaHafafafafayahab
aaaIagahahakaJaDaDaDaDaKakakaLafafafafahab
aaanahahahakaMaNaOaObjaDakaPafafaQaQahahab
abaRahahahakakakakakaSaEakaTazafaTahahahai
aaaUahahahakaVaWaXakaYaYaZaTafafaTahahahal
aaadahahahakbabababbaYaYaZaTafafaTahahanab
aaacadahahakbcbdbeakbfaYaZaTafafaTahahbgaa
abafahahahakakakakakaSaEakaTafafaTahahaRab
aaaUahahahahahahahahafafahahafayahahahbgaa
aaabahahahahahahahafafacafahahahahahanaIaa
abalafahahanaUanaRbhbibibianabababbgaaabaa
aaaaababaiabaaabaabibibibhaaabaiabaiaaaaaa
"}
