//MAP CONVERTED BY dmm2tgm.py THIS HEADER COMMENT PREVENTS RECONVERSION, DO NOT REMOVE
"aD" = (
/obj/spawner/junk/low_chance,
/turf/simulated/floor/tiled/steel/bar_dance/airless,
/area/template_noop)
"aH" = (
/obj/item/modular_computer/console{
	dir = 4
	},
/turf/simulated/floor/tiled/dark/gray_perforated/airless,
/area/template_noop)
"aJ" = (
/obj/structure/bed/chair/comfy/black{
	dir = 8
	},
/obj/spawner/gun/cheap/low_chance,
/turf/simulated/floor/tiled/dark/gray_perforated/airless,
/area/template_noop)
"bc" = (
/obj/spawner/pack/machine,
/obj/machinery/light{
	dir = 1
	},
/turf/simulated/floor/tiled/steel/bar_dance/airless,
/area/template_noop)
"bi" = (
/turf/template_noop,
/area/template_noop)
"bx" = (
/obj/spawner/credits/c50,
/turf/simulated/floor/tiled/steel/bar_dance/airless,
/area/template_noop)
"by" = (
/turf/simulated/floor/tiled/dark/gray_perforated/airless,
/area/template_noop)
"bB" = (
/obj/item/modular_computer/console,
/turf/simulated/floor/tiled/dark/gray_perforated/airless,
/area/template_noop)
"bE" = (
/obj/spawner/scrap/sparse/low_chance,
/turf/simulated/floor/tiled/steel/bar_flat/airless,
/area/template_noop)
"bG" = (
/obj/structure/bed/padded,
/obj/item/bedsheet/medical,
/obj/spawner/medical_lowcost/low_chance,
/turf/simulated/floor/tiled/white/airless,
/area/template_noop)
"cW" = (
/obj/structure/table/standard,
/obj/spawner/pack/rare/low_chance,
/obj/spawner/pack/rare/low_chance,
/turf/simulated/floor/tiled/dark/gray_perforated/airless,
/area/template_noop)
"dv" = (
/obj/spawner/junkfood/rotten/low_chance,
/turf/simulated/floor/tiled/steel/bar_dance/airless,
/area/template_noop)
"dI" = (
/obj/structure/table/bar_special,
/turf/simulated/floor/tiled/steel/bar_flat/airless,
/area/template_noop)
"dN" = (
/obj/structure/bed/chair/shuttle,
/turf/simulated/floor/tiled/steel/orangecorner/airless,
/area/template_noop)
"eg" = (
/obj/structure/table/bar_special,
/obj/item/device/synthesized_instrument/violin,
/turf/simulated/floor/tiled/steel/bar_flat/airless,
/area/template_noop)
"eo" = (
/obj/machinery/slotmachine,
/turf/simulated/floor/tiled/steel/bar_light/airless,
/area/template_noop)
"eN" = (
/obj/structure/bed/chair/comfy/black{
	dir = 8
	},
/obj/spawner/credits/c100,
/turf/simulated/floor/tiled/steel/bar_light/airless,
/area/template_noop)
"fb" = (
/mob/living/simple_animal/hostile/hivebot,
/turf/simulated/floor/tiled/steel/orangecorner/airless,
/area/template_noop)
"fk" = (
/obj/item/stool/custom/bar_special,
/obj/spawner/junkfood/low_chance,
/obj/machinery/light{
	dir = 4
	},
/turf/simulated/floor/tiled/steel/bar_flat/airless,
/area/template_noop)
"fl" = (
/obj/spawner/contraband/low_chance,
/turf/simulated/floor/tiled/steel/bar_dance/airless,
/area/template_noop)
"gQ" = (
/obj/structure/shuttle/engine/propulsion,
/turf/template_noop,
/area/template_noop)
"hF" = (
/obj/structure/bed/chair/comfy/black{
	dir = 1
	},
/obj/spawner/lowkeyrandom,
/obj/machinery/light{
	dir = 4
	},
/turf/simulated/floor/tiled/dark/gray_perforated/airless,
/area/template_noop)
"ip" = (
/obj/structure/sign/faction/ironhammer,
/turf/simulated/wall/r_wall,
/area/template_noop)
"jh" = (
/obj/structure/table/bar_special,
/obj/item/dice,
/turf/simulated/floor/tiled/steel/bar_light/airless,
/area/template_noop)
"kF" = (
/obj/structure/table/bar_special,
/obj/spawner/soda/low_chance,
/turf/simulated/floor/tiled/steel/bar_flat/airless,
/area/template_noop)
"kW" = (
/mob/living/simple_animal/hostile/hivebot,
/turf/simulated/floor/tiled/steel/bar_dance/airless,
/area/template_noop)
"lA" = (
/obj/machinery/vending/boozeomat,
/turf/simulated/floor/tiled/steel/bar_light/airless,
/area/template_noop)
"ni" = (
/obj/spawner/scrap/sparse/low_chance,
/turf/simulated/floor/tiled/steel/bar_dance/airless,
/area/template_noop)
"ou" = (
/obj/item/stool/custom/bar_special,
/obj/spawner/junkfood/rotten/low_chance,
/turf/simulated/floor/tiled/steel/bar_flat/airless,
/area/template_noop)
"oL" = (
/obj/structure/bed/chair/shuttle{
	dir = 1
	},
/obj/spawner/ammo/low_cost,
/turf/simulated/floor/tiled/steel/orangecorner/airless,
/area/template_noop)
"oX" = (
/obj/structure/bed/chair/custom/bar_special,
/turf/simulated/floor/tiled/steel/bar_flat/airless,
/area/template_noop)
"py" = (
/obj/machinery/light{
	dir = 1
	},
/turf/simulated/floor/tiled/steel/bar_flat/airless,
/area/template_noop)
"qA" = (
/obj/structure/bed/chair/shuttle{
	dir = 1
	},
/obj/spawner/ammo/lowcost,
/turf/simulated/floor/tiled/steel/orangecorner/airless,
/area/template_noop)
"qX" = (
/turf/simulated/floor/tiled/white/airless,
/area/template_noop)
"rd" = (
/obj/structure/bed/chair/shuttle,
/obj/spawner/ammo/low_cost,
/turf/simulated/floor/tiled/steel/orangecorner/airless,
/area/template_noop)
"rk" = (
/obj/item/stool/custom/bar_special,
/obj/spawner/credits/c100,
/turf/simulated/floor/tiled/steel/bar_flat/airless,
/area/template_noop)
"sz" = (
/obj/machinery/light{
	dir = 1
	},
/turf/simulated/floor/tiled/steel/bar_dance/airless,
/area/template_noop)
"vo" = (
/obj/machinery/recharge_station,
/turf/simulated/floor/tiled/steel/bar_dance/airless,
/area/template_noop)
"vs" = (
/obj/structure/bed/padded,
/obj/item/bedsheet/medical,
/obj/spawner/medical_lowcost/low_chance,
/obj/machinery/light{
	dir = 4
	},
/turf/simulated/floor/tiled/white/airless,
/area/template_noop)
"vt" = (
/obj/structure/girder,
/turf/simulated/floor/plating/under/airless,
/area/template_noop)
"vw" = (
/obj/structure/bed/chair/shuttle{
	dir = 4
	},
/turf/simulated/floor/tiled/steel/orangecorner/airless,
/area/template_noop)
"wv" = (
/obj/structure/table/bar_special,
/obj/spawner/booze/low_chance,
/turf/simulated/floor/tiled/steel/bar_flat/airless,
/area/template_noop)
"wH" = (
/obj/structure/table/bar_special,
/obj/spawner/booze/low_chance,
/turf/simulated/floor/tiled/steel/bar_light/airless,
/area/template_noop)
"wN" = (
/obj/structure/table/bar_special,
/obj/machinery/chemical_dispenser/soda,
/turf/simulated/floor/tiled/steel/bar_light/airless,
/area/template_noop)
"wU" = (
/obj/machinery/media/jukebox,
/turf/simulated/floor/tiled/steel/bar_light/airless,
/area/template_noop)
"yu" = (
/obj/spawner/soda/low_chance,
/turf/simulated/floor/tiled/steel/bar_dance/airless,
/area/template_noop)
"yH" = (
/obj/structure/bed/chair/custom/bar_special{
	dir = 4
	},
/obj/spawner/booze/low_chance,
/turf/simulated/floor/tiled/steel/bar_light/airless,
/area/template_noop)
"zm" = (
/obj/machinery/light,
/turf/simulated/floor/tiled/steel/bar_dance/airless,
/area/template_noop)
"zM" = (
/obj/structure/table/bar_special,
/obj/item/device/synthesized_instrument/guitar,
/turf/simulated/floor/tiled/steel/bar_flat/airless,
/area/template_noop)
"Ap" = (
/obj/spawner/lowkeyrandom/low_chance,
/turf/simulated/floor/tiled/steel/bar_dance/airless,
/area/template_noop)
"Bq" = (
/obj/structure/table/standard,
/obj/spawner/firstaid,
/turf/simulated/floor/tiled/white/airless,
/area/template_noop)
"BQ" = (
/obj/machinery/door/firedoor,
/obj/machinery/door/airlock/freezer{
	frequency = 1380;
	icon_state = "door_locked";
	id_tag = "escape_pod_1_berth_hatch";
	locked = 1;
	name = "Shuttle Hatch";
	req_access = list(13)
	},
/turf/simulated/floor/tiled/steel/cargo/airless,
/area/template_noop)
"Db" = (
/obj/structure/toilet{
	dir = 1
	},
/obj/spawner/toy,
/turf/simulated/floor/tiled/steel/bar_dance/airless,
/area/template_noop)
"Dl" = (
/obj/structure/bed/chair/comfy/black{
	dir = 1
	},
/obj/spawner/lowkeyrandom,
/turf/simulated/floor/tiled/dark/gray_perforated/airless,
/area/template_noop)
"DT" = (
/obj/structure/cyberplant,
/turf/simulated/floor/tiled/steel/bar_flat/airless,
/area/template_noop)
"Ed" = (
/obj/structure/table/bar_special,
/obj/spawner/pizza/low_chance,
/turf/simulated/floor/tiled/steel/bar_flat/airless,
/area/template_noop)
"Eg" = (
/obj/structure/bed/chair/comfy/black{
	dir = 1
	},
/obj/spawner/credits/low_chance,
/turf/simulated/floor/tiled/dark/gray_perforated/airless,
/area/template_noop)
"EL" = (
/obj/structure/table/bar_special,
/obj/item/reagent_containers/food/drinks/shaker,
/turf/simulated/floor/tiled/steel/bar_light/airless,
/area/template_noop)
"Fa" = (
/mob/living/simple_animal/hostile/hivebot/range,
/turf/simulated/floor/tiled/steel/bar_dance/airless,
/area/template_noop)
"FH" = (
/obj/item/stool/custom/bar_special,
/turf/simulated/floor/tiled/steel/bar_flat/airless,
/area/template_noop)
"Ga" = (
/obj/structure/cyberplant,
/turf/simulated/floor/tiled/steel/orangecorner/airless,
/area/template_noop)
"Hh" = (
/obj/machinery/vending/dinnerware,
/turf/simulated/floor/tiled/steel/bar_light/airless,
/area/template_noop)
"Hn" = (
/obj/machinery/door/firedoor,
/obj/effect/window_lwall_spawn/reinforced,
/turf/simulated/floor/plating/airless,
/area/template_noop)
"Ht" = (
/obj/structure/table/bar_special,
/obj/item/deck/cards,
/turf/simulated/floor/tiled/steel/bar_light/airless,
/area/template_noop)
"IG" = (
/obj/machinery/door/firedoor,
/obj/machinery/door/airlock{
	name = "Unisex Restrooms"
	},
/turf/simulated/floor/tiled/steel/bar_light/airless,
/area/template_noop)
"Jp" = (
/turf/simulated/floor/tiled/steel/bar_light/airless,
/area/template_noop)
"Km" = (
/obj/machinery/door/firedoor,
/obj/machinery/door/airlock/security{
	req_access = list(1)
	},
/turf/simulated/floor/tiled/steel/cargo/airless,
/area/template_noop)
"La" = (
/mob/living/simple_animal/hostile/hivebot,
/turf/simulated/floor/tiled/white/airless,
/area/template_noop)
"LQ" = (
/obj/structure/bed/chair/shuttle,
/obj/spawner/gun/cheap/low_chance,
/obj/machinery/light{
	dir = 1
	},
/turf/simulated/floor/tiled/steel/orangecorner/airless,
/area/template_noop)
"Nh" = (
/obj/structure/curtain/open/shower,
/obj/machinery/shower{
	dir = 1
	},
/turf/simulated/floor/tiled/white/techfloor_grid/airless,
/area/template_noop)
"Pp" = (
/obj/structure/toilet{
	dir = 1
	},
/obj/spawner/contraband/low_chance,
/turf/simulated/floor/tiled/steel/bar_dance/airless,
/area/template_noop)
"PO" = (
/obj/machinery/door/firedoor,
/obj/machinery/door/airlock/glass_medical{
	id_tag = null;
	name = "Medical Bay";
	req_access = list(5)
	},
/turf/simulated/floor/tiled/steel/cargo/airless,
/area/template_noop)
"Rh" = (
/obj/structure/sign/department/medbay,
/turf/simulated/wall/r_wall,
/area/template_noop)
"Rq" = (
/obj/structure/bed/chair/custom/bar_special{
	dir = 4
	},
/turf/simulated/floor/tiled/steel/bar_light/airless,
/area/template_noop)
"RW" = (
/obj/structure/shuttle/engine/propulsion{
	icon_state = "propulsion_l"
	},
/turf/template_noop,
/area/template_noop)
"Sy" = (
/mob/living/simple_animal/hostile/hivebot/range,
/turf/simulated/floor/plating/under/airless,
/area/template_noop)
"Vq" = (
/obj/machinery/sleeper{
	dir = 4
	},
/turf/simulated/floor/tiled/white/airless,
/area/template_noop)
"Vt" = (
/obj/machinery/door/firedoor,
/obj/machinery/door/airlock/glass_command{
	name = "Bridge";
	req_access = list(19)
	},
/turf/simulated/floor/tiled/dark/cargo/airless,
/area/template_noop)
"VJ" = (
/turf/simulated/floor/plating/under/airless,
/area/template_noop)
"WC" = (
/obj/spawner/medical,
/turf/simulated/floor/tiled/white/airless,
/area/template_noop)
"WH" = (
/obj/spawner/junk/low_chance,
/turf/simulated/floor/tiled/white/airless,
/area/template_noop)
"Xm" = (
/obj/structure/lattice,
/turf/template_noop,
/area/template_noop)
"Xr" = (
/turf/space,
/area/template_noop)
"Xv" = (
/turf/simulated/floor/tiled/steel/bar_dance/airless,
/area/template_noop)
"XR" = (
/mob/living/simple_animal/hostile/hivebot,
/turf/simulated/floor/plating/under/airless,
/area/template_noop)
"Yj" = (
/obj/structure/cyberplant,
/turf/simulated/floor/tiled/steel/bar_light/airless,
/area/template_noop)
"Yp" = (
/obj/structure/medical_stand,
/turf/simulated/floor/tiled/white/airless,
/area/template_noop)
"YW" = (
/turf/simulated/floor/tiled/steel/orangecorner/airless,
/area/template_noop)
"YZ" = (
/turf/simulated/wall/r_wall,
/area/template_noop)
"Zt" = (
/turf/simulated/floor/tiled/steel/bar_flat/airless,
/area/template_noop)
"Zy" = (
/obj/structure/shuttle/engine/heater,
/obj/structure/window/reinforced/crescent{
	dir = 1
	},
/turf/simulated/floor/airless,
/area/template_noop)
"ZY" = (
/obj/machinery/door/firedoor,
/obj/effect/window_lwall_spawn/smartspawn,
/turf/simulated/floor/plating/airless,
/area/template_noop)

(1,1,1) = {"
bi
bi
bi
bi
bi
bi
bi
bi
bi
bi
bi
bi
bi
bi
bi
bi
bi
bi
bi
bi
bi
bi
bi
bi
bi
"}
(2,1,1) = {"
bi
bi
bi
bi
bi
bi
bi
bi
bi
bi
bi
bi
bi
bi
bi
bi
bi
bi
bi
bi
bi
bi
bi
bi
bi
"}
(3,1,1) = {"
bi
bi
bi
bi
bi
bi
bi
bi
bi
bi
bi
bi
bi
bi
bi
bi
bi
bi
bi
bi
bi
bi
bi
bi
bi
"}
(4,1,1) = {"
bi
bi
bi
bi
bi
bi
bi
bi
bi
bi
bi
bi
bi
bi
bi
bi
bi
bi
bi
bi
bi
bi
bi
bi
bi
"}
(5,1,1) = {"
bi
bi
bi
bi
bi
bi
bi
bi
bi
bi
bi
bi
bi
bi
bi
bi
bi
bi
bi
bi
bi
bi
bi
bi
bi
"}
(6,1,1) = {"
bi
bi
bi
bi
bi
bi
bi
bi
bi
bi
bi
bi
bi
bi
bi
bi
bi
bi
bi
bi
bi
bi
bi
bi
bi
"}
(7,1,1) = {"
bi
bi
bi
bi
bi
bi
YZ
YZ
YZ
BQ
YZ
BQ
YZ
Hn
Hn
Hn
YZ
BQ
YZ
BQ
YZ
YZ
YZ
Xm
bi
"}
(8,1,1) = {"
bi
bi
bi
bi
bi
YZ
YZ
Ga
vw
YW
YZ
Xv
bE
yH
Yj
Rq
VJ
VJ
vt
VJ
IG
Pp
YZ
YZ
bi
"}
(9,1,1) = {"
bi
bi
bi
bi
YZ
YZ
YZ
LQ
YW
YW
YZ
Xv
oX
jh
Ht
wH
FH
XR
Xm
VJ
YZ
YZ
Zy
gQ
bi
"}
(10,1,1) = {"
bi
bi
bi
Xm
vt
aH
YZ
dN
fb
oL
YZ
Xv
oX
wH
eN
wH
rk
VJ
Xr
VJ
IG
Db
Zy
gQ
bi
"}
(11,1,1) = {"
bi
vt
vt
Xm
VJ
aJ
YZ
rd
YW
qA
YZ
sz
Zt
Zt
Zt
Zt
Zt
VJ
vt
VJ
YZ
YZ
Zy
RW
bi
"}
(12,1,1) = {"
YZ
YZ
VJ
VJ
VJ
VJ
YZ
ZY
Km
ZY
ip
bx
Xv
dv
Xv
Ap
yu
aD
YZ
py
IG
fl
YZ
YZ
bi
"}
(13,1,1) = {"
Hn
bB
Eg
YW
Sy
VJ
Vt
Xv
Xv
Xv
ni
Xv
Xv
kW
dv
Xv
Xv
aD
YZ
Nh
YZ
vo
YZ
bi
bi
"}
(14,1,1) = {"
YZ
YZ
bB
Dl
YW
YW
YZ
dv
Xv
Xv
Fa
Xv
Xv
yu
Xv
Xv
Fa
aD
YZ
YZ
YZ
YZ
YZ
YZ
bi
"}
(15,1,1) = {"
bi
YZ
YZ
bB
hF
by
YZ
bc
Xv
ou
FH
ou
rk
FH
ou
FH
DT
zm
Rh
Bq
qX
Vq
Zy
RW
bi
"}
(16,1,1) = {"
bi
bi
YZ
Hn
YZ
cW
YZ
eo
Jp
zM
Ed
wv
dI
Ed
wv
kF
rk
Xv
PO
qX
La
WC
Zy
gQ
bi
"}
(17,1,1) = {"
bi
bi
bi
bi
YZ
YZ
YZ
wU
Jp
eg
Zt
Zt
Zt
Zt
Zt
wv
FH
Ap
ZY
qX
qX
WH
Zy
RW
bi
"}
(18,1,1) = {"
bi
bi
bi
bi
bi
YZ
YZ
Yj
VJ
VJ
VJ
lA
EL
wN
Hh
wv
fk
ni
ZY
bG
vs
Yp
YZ
YZ
bi
"}
(19,1,1) = {"
bi
bi
bi
bi
bi
bi
YZ
YZ
Xm
bi
Xm
vt
YZ
Hn
Hn
Hn
YZ
Hn
YZ
YZ
YZ
YZ
YZ
bi
bi
"}
(20,1,1) = {"
bi
bi
bi
bi
bi
bi
bi
bi
bi
bi
bi
bi
bi
bi
bi
bi
bi
bi
bi
bi
bi
bi
bi
bi
bi
"}
(21,1,1) = {"
bi
bi
bi
bi
bi
bi
bi
bi
bi
bi
bi
bi
bi
bi
bi
bi
bi
bi
bi
bi
bi
bi
bi
bi
bi
"}
(22,1,1) = {"
bi
bi
bi
bi
bi
bi
bi
bi
bi
bi
bi
bi
bi
bi
bi
bi
bi
bi
bi
bi
bi
bi
bi
bi
bi
"}
(23,1,1) = {"
bi
bi
bi
bi
bi
bi
bi
bi
bi
bi
bi
bi
bi
bi
bi
bi
bi
bi
bi
bi
bi
bi
bi
bi
bi
"}
(24,1,1) = {"
bi
bi
bi
bi
bi
bi
bi
bi
bi
bi
bi
bi
bi
bi
bi
bi
bi
bi
bi
bi
bi
bi
bi
bi
bi
"}
(25,1,1) = {"
bi
bi
bi
bi
bi
bi
bi
bi
bi
bi
bi
bi
bi
bi
bi
bi
bi
bi
bi
bi
bi
bi
bi
bi
bi
"}
