//MAP CONVERTED BY dmm2tgm.py THIS HEADER COMMENT PREVENTS RECONVERSION, DO NOT REMOVE
"Ls" = (
/turf/space,
/area/template_noop)

(1,1,1) = {"
Ls
Ls
Ls
Ls
Ls
Ls
Ls
Ls
Ls
Ls
Ls
Ls
Ls
Ls
Ls
Ls
Ls
Ls
Ls
Ls
Ls
Ls
Ls
Ls
Ls
Ls
Ls
Ls
Ls
Ls
Ls
Ls
Ls
Ls
Ls
Ls
Ls
Ls
Ls
Ls
Ls
Ls
Ls
Ls
Ls
Ls
Ls
"}
(2,1,1) = {"
Ls
Ls
Ls
Ls
Ls
Ls
Ls
Ls
Ls
Ls
Ls
Ls
Ls
Ls
Ls
Ls
Ls
Ls
Ls
Ls
Ls
Ls
Ls
Ls
Ls
Ls
Ls
Ls
Ls
Ls
Ls
Ls
Ls
Ls
Ls
Ls
Ls
Ls
Ls
Ls
Ls
Ls
Ls
Ls
Ls
Ls
Ls
"}
(3,1,1) = {"
Ls
Ls
Ls
Ls
Ls
Ls
Ls
Ls
Ls
Ls
Ls
Ls
Ls
Ls
Ls
Ls
Ls
Ls
Ls
Ls
Ls
Ls
Ls
Ls
Ls
Ls
Ls
Ls
Ls
Ls
Ls
Ls
Ls
Ls
Ls
Ls
Ls
Ls
Ls
Ls
Ls
Ls
Ls
Ls
Ls
Ls
Ls
"}
(4,1,1) = {"
Ls
Ls
Ls
Ls
Ls
Ls
Ls
Ls
Ls
Ls
Ls
Ls
Ls
Ls
Ls
Ls
Ls
Ls
Ls
Ls
Ls
Ls
Ls
Ls
Ls
Ls
Ls
Ls
Ls
Ls
Ls
Ls
Ls
Ls
Ls
Ls
Ls
Ls
Ls
Ls
Ls
Ls
Ls
Ls
Ls
Ls
Ls
"}
(5,1,1) = {"
Ls
Ls
Ls
Ls
Ls
Ls
Ls
Ls
Ls
Ls
Ls
Ls
Ls
Ls
Ls
Ls
Ls
Ls
Ls
Ls
Ls
Ls
Ls
Ls
Ls
Ls
Ls
Ls
Ls
Ls
Ls
Ls
Ls
Ls
Ls
Ls
Ls
Ls
Ls
Ls
Ls
Ls
Ls
Ls
Ls
Ls
Ls
"}
(6,1,1) = {"
Ls
Ls
Ls
Ls
Ls
Ls
Ls
Ls
Ls
Ls
Ls
Ls
Ls
Ls
Ls
Ls
Ls
Ls
Ls
Ls
Ls
Ls
Ls
Ls
Ls
Ls
Ls
Ls
Ls
Ls
Ls
Ls
Ls
Ls
Ls
Ls
Ls
Ls
Ls
Ls
Ls
Ls
Ls
Ls
Ls
Ls
Ls
"}
(7,1,1) = {"
Ls
Ls
Ls
Ls
Ls
Ls
Ls
Ls
Ls
Ls
Ls
Ls
Ls
Ls
Ls
Ls
Ls
Ls
Ls
Ls
Ls
Ls
Ls
Ls
Ls
Ls
Ls
Ls
Ls
Ls
Ls
Ls
Ls
Ls
Ls
Ls
Ls
Ls
Ls
Ls
Ls
Ls
Ls
Ls
Ls
Ls
Ls
"}
(8,1,1) = {"
Ls
Ls
Ls
Ls
Ls
Ls
Ls
Ls
Ls
Ls
Ls
Ls
Ls
Ls
Ls
Ls
Ls
Ls
Ls
Ls
Ls
Ls
Ls
Ls
Ls
Ls
Ls
Ls
Ls
Ls
Ls
Ls
Ls
Ls
Ls
Ls
Ls
Ls
Ls
Ls
Ls
Ls
Ls
Ls
Ls
Ls
Ls
"}
(9,1,1) = {"
Ls
Ls
Ls
Ls
Ls
Ls
Ls
Ls
Ls
Ls
Ls
Ls
Ls
Ls
Ls
Ls
Ls
Ls
Ls
Ls
Ls
Ls
Ls
Ls
Ls
Ls
Ls
Ls
Ls
Ls
Ls
Ls
Ls
Ls
Ls
Ls
Ls
Ls
Ls
Ls
Ls
Ls
Ls
Ls
Ls
Ls
Ls
"}
(10,1,1) = {"
Ls
Ls
Ls
Ls
Ls
Ls
Ls
Ls
Ls
Ls
Ls
Ls
Ls
Ls
Ls
Ls
Ls
Ls
Ls
Ls
Ls
Ls
Ls
Ls
Ls
Ls
Ls
Ls
Ls
Ls
Ls
Ls
Ls
Ls
Ls
Ls
Ls
Ls
Ls
Ls
Ls
Ls
Ls
Ls
Ls
Ls
Ls
"}
(11,1,1) = {"
Ls
Ls
Ls
Ls
Ls
Ls
Ls
Ls
Ls
Ls
Ls
Ls
Ls
Ls
Ls
Ls
Ls
Ls
Ls
Ls
Ls
Ls
Ls
Ls
Ls
Ls
Ls
Ls
Ls
Ls
Ls
Ls
Ls
Ls
Ls
Ls
Ls
Ls
Ls
Ls
Ls
Ls
Ls
Ls
Ls
Ls
Ls
"}
(12,1,1) = {"
Ls
Ls
Ls
Ls
Ls
Ls
Ls
Ls
Ls
Ls
Ls
Ls
Ls
Ls
Ls
Ls
Ls
Ls
Ls
Ls
Ls
Ls
Ls
Ls
Ls
Ls
Ls
Ls
Ls
Ls
Ls
Ls
Ls
Ls
Ls
Ls
Ls
Ls
Ls
Ls
Ls
Ls
Ls
Ls
Ls
Ls
Ls
"}
(13,1,1) = {"
Ls
Ls
Ls
Ls
Ls
Ls
Ls
Ls
Ls
Ls
Ls
Ls
Ls
Ls
Ls
Ls
Ls
Ls
Ls
Ls
Ls
Ls
Ls
Ls
Ls
Ls
Ls
Ls
Ls
Ls
Ls
Ls
Ls
Ls
Ls
Ls
Ls
Ls
Ls
Ls
Ls
Ls
Ls
Ls
Ls
Ls
Ls
"}
(14,1,1) = {"
Ls
Ls
Ls
Ls
Ls
Ls
Ls
Ls
Ls
Ls
Ls
Ls
Ls
Ls
Ls
Ls
Ls
Ls
Ls
Ls
Ls
Ls
Ls
Ls
Ls
Ls
Ls
Ls
Ls
Ls
Ls
Ls
Ls
Ls
Ls
Ls
Ls
Ls
Ls
Ls
Ls
Ls
Ls
Ls
Ls
Ls
Ls
"}
(15,1,1) = {"
Ls
Ls
Ls
Ls
Ls
Ls
Ls
Ls
Ls
Ls
Ls
Ls
Ls
Ls
Ls
Ls
Ls
Ls
Ls
Ls
Ls
Ls
Ls
Ls
Ls
Ls
Ls
Ls
Ls
Ls
Ls
Ls
Ls
Ls
Ls
Ls
Ls
Ls
Ls
Ls
Ls
Ls
Ls
Ls
Ls
Ls
Ls
"}
(16,1,1) = {"
Ls
Ls
Ls
Ls
Ls
Ls
Ls
Ls
Ls
Ls
Ls
Ls
Ls
Ls
Ls
Ls
Ls
Ls
Ls
Ls
Ls
Ls
Ls
Ls
Ls
Ls
Ls
Ls
Ls
Ls
Ls
Ls
Ls
Ls
Ls
Ls
Ls
Ls
Ls
Ls
Ls
Ls
Ls
Ls
Ls
Ls
Ls
"}
(17,1,1) = {"
Ls
Ls
Ls
Ls
Ls
Ls
Ls
Ls
Ls
Ls
Ls
Ls
Ls
Ls
Ls
Ls
Ls
Ls
Ls
Ls
Ls
Ls
Ls
Ls
Ls
Ls
Ls
Ls
Ls
Ls
Ls
Ls
Ls
Ls
Ls
Ls
Ls
Ls
Ls
Ls
Ls
Ls
Ls
Ls
Ls
Ls
Ls
"}
(18,1,1) = {"
Ls
Ls
Ls
Ls
Ls
Ls
Ls
Ls
Ls
Ls
Ls
Ls
Ls
Ls
Ls
Ls
Ls
Ls
Ls
Ls
Ls
Ls
Ls
Ls
Ls
Ls
Ls
Ls
Ls
Ls
Ls
Ls
Ls
Ls
Ls
Ls
Ls
Ls
Ls
Ls
Ls
Ls
Ls
Ls
Ls
Ls
Ls
"}
(19,1,1) = {"
Ls
Ls
Ls
Ls
Ls
Ls
Ls
Ls
Ls
Ls
Ls
Ls
Ls
Ls
Ls
Ls
Ls
Ls
Ls
Ls
Ls
Ls
Ls
Ls
Ls
Ls
Ls
Ls
Ls
Ls
Ls
Ls
Ls
Ls
Ls
Ls
Ls
Ls
Ls
Ls
Ls
Ls
Ls
Ls
Ls
Ls
Ls
"}
(20,1,1) = {"
Ls
Ls
Ls
Ls
Ls
Ls
Ls
Ls
Ls
Ls
Ls
Ls
Ls
Ls
Ls
Ls
Ls
Ls
Ls
Ls
Ls
Ls
Ls
Ls
Ls
Ls
Ls
Ls
Ls
Ls
Ls
Ls
Ls
Ls
Ls
Ls
Ls
Ls
Ls
Ls
Ls
Ls
Ls
Ls
Ls
Ls
Ls
"}
(21,1,1) = {"
Ls
Ls
Ls
Ls
Ls
Ls
Ls
Ls
Ls
Ls
Ls
Ls
Ls
Ls
Ls
Ls
Ls
Ls
Ls
Ls
Ls
Ls
Ls
Ls
Ls
Ls
Ls
Ls
Ls
Ls
Ls
Ls
Ls
Ls
Ls
Ls
Ls
Ls
Ls
Ls
Ls
Ls
Ls
Ls
Ls
Ls
Ls
"}
(22,1,1) = {"
Ls
Ls
Ls
Ls
Ls
Ls
Ls
Ls
Ls
Ls
Ls
Ls
Ls
Ls
Ls
Ls
Ls
Ls
Ls
Ls
Ls
Ls
Ls
Ls
Ls
Ls
Ls
Ls
Ls
Ls
Ls
Ls
Ls
Ls
Ls
Ls
Ls
Ls
Ls
Ls
Ls
Ls
Ls
Ls
Ls
Ls
Ls
"}
(23,1,1) = {"
Ls
Ls
Ls
Ls
Ls
Ls
Ls
Ls
Ls
Ls
Ls
Ls
Ls
Ls
Ls
Ls
Ls
Ls
Ls
Ls
Ls
Ls
Ls
Ls
Ls
Ls
Ls
Ls
Ls
Ls
Ls
Ls
Ls
Ls
Ls
Ls
Ls
Ls
Ls
Ls
Ls
Ls
Ls
Ls
Ls
Ls
Ls
"}
(24,1,1) = {"
Ls
Ls
Ls
Ls
Ls
Ls
Ls
Ls
Ls
Ls
Ls
Ls
Ls
Ls
Ls
Ls
Ls
Ls
Ls
Ls
Ls
Ls
Ls
Ls
Ls
Ls
Ls
Ls
Ls
Ls
Ls
Ls
Ls
Ls
Ls
Ls
Ls
Ls
Ls
Ls
Ls
Ls
Ls
Ls
Ls
Ls
Ls
"}
(25,1,1) = {"
Ls
Ls
Ls
Ls
Ls
Ls
Ls
Ls
Ls
Ls
Ls
Ls
Ls
Ls
Ls
Ls
Ls
Ls
Ls
Ls
Ls
Ls
Ls
Ls
Ls
Ls
Ls
Ls
Ls
Ls
Ls
Ls
Ls
Ls
Ls
Ls
Ls
Ls
Ls
Ls
Ls
Ls
Ls
Ls
Ls
Ls
Ls
"}
(26,1,1) = {"
Ls
Ls
Ls
Ls
Ls
Ls
Ls
Ls
Ls
Ls
Ls
Ls
Ls
Ls
Ls
Ls
Ls
Ls
Ls
Ls
Ls
Ls
Ls
Ls
Ls
Ls
Ls
Ls
Ls
Ls
Ls
Ls
Ls
Ls
Ls
Ls
Ls
Ls
Ls
Ls
Ls
Ls
Ls
Ls
Ls
Ls
Ls
"}
(27,1,1) = {"
Ls
Ls
Ls
Ls
Ls
Ls
Ls
Ls
Ls
Ls
Ls
Ls
Ls
Ls
Ls
Ls
Ls
Ls
Ls
Ls
Ls
Ls
Ls
Ls
Ls
Ls
Ls
Ls
Ls
Ls
Ls
Ls
Ls
Ls
Ls
Ls
Ls
Ls
Ls
Ls
Ls
Ls
Ls
Ls
Ls
Ls
Ls
"}
(28,1,1) = {"
Ls
Ls
Ls
Ls
Ls
Ls
Ls
Ls
Ls
Ls
Ls
Ls
Ls
Ls
Ls
Ls
Ls
Ls
Ls
Ls
Ls
Ls
Ls
Ls
Ls
Ls
Ls
Ls
Ls
Ls
Ls
Ls
Ls
Ls
Ls
Ls
Ls
Ls
Ls
Ls
Ls
Ls
Ls
Ls
Ls
Ls
Ls
"}
(29,1,1) = {"
Ls
Ls
Ls
Ls
Ls
Ls
Ls
Ls
Ls
Ls
Ls
Ls
Ls
Ls
Ls
Ls
Ls
Ls
Ls
Ls
Ls
Ls
Ls
Ls
Ls
Ls
Ls
Ls
Ls
Ls
Ls
Ls
Ls
Ls
Ls
Ls
Ls
Ls
Ls
Ls
Ls
Ls
Ls
Ls
Ls
Ls
Ls
"}
(30,1,1) = {"
Ls
Ls
Ls
Ls
Ls
Ls
Ls
Ls
Ls
Ls
Ls
Ls
Ls
Ls
Ls
Ls
Ls
Ls
Ls
Ls
Ls
Ls
Ls
Ls
Ls
Ls
Ls
Ls
Ls
Ls
Ls
Ls
Ls
Ls
Ls
Ls
Ls
Ls
Ls
Ls
Ls
Ls
Ls
Ls
Ls
Ls
Ls
"}
(31,1,1) = {"
Ls
Ls
Ls
Ls
Ls
Ls
Ls
Ls
Ls
Ls
Ls
Ls
Ls
Ls
Ls
Ls
Ls
Ls
Ls
Ls
Ls
Ls
Ls
Ls
Ls
Ls
Ls
Ls
Ls
Ls
Ls
Ls
Ls
Ls
Ls
Ls
Ls
Ls
Ls
Ls
Ls
Ls
Ls
Ls
Ls
Ls
Ls
"}
(32,1,1) = {"
Ls
Ls
Ls
Ls
Ls
Ls
Ls
Ls
Ls
Ls
Ls
Ls
Ls
Ls
Ls
Ls
Ls
Ls
Ls
Ls
Ls
Ls
Ls
Ls
Ls
Ls
Ls
Ls
Ls
Ls
Ls
Ls
Ls
Ls
Ls
Ls
Ls
Ls
Ls
Ls
Ls
Ls
Ls
Ls
Ls
Ls
Ls
"}
(33,1,1) = {"
Ls
Ls
Ls
Ls
Ls
Ls
Ls
Ls
Ls
Ls
Ls
Ls
Ls
Ls
Ls
Ls
Ls
Ls
Ls
Ls
Ls
Ls
Ls
Ls
Ls
Ls
Ls
Ls
Ls
Ls
Ls
Ls
Ls
Ls
Ls
Ls
Ls
Ls
Ls
Ls
Ls
Ls
Ls
Ls
Ls
Ls
Ls
"}
(34,1,1) = {"
Ls
Ls
Ls
Ls
Ls
Ls
Ls
Ls
Ls
Ls
Ls
Ls
Ls
Ls
Ls
Ls
Ls
Ls
Ls
Ls
Ls
Ls
Ls
Ls
Ls
Ls
Ls
Ls
Ls
Ls
Ls
Ls
Ls
Ls
Ls
Ls
Ls
Ls
Ls
Ls
Ls
Ls
Ls
Ls
Ls
Ls
Ls
"}
(35,1,1) = {"
Ls
Ls
Ls
Ls
Ls
Ls
Ls
Ls
Ls
Ls
Ls
Ls
Ls
Ls
Ls
Ls
Ls
Ls
Ls
Ls
Ls
Ls
Ls
Ls
Ls
Ls
Ls
Ls
Ls
Ls
Ls
Ls
Ls
Ls
Ls
Ls
Ls
Ls
Ls
Ls
Ls
Ls
Ls
Ls
Ls
Ls
Ls
"}
(36,1,1) = {"
Ls
Ls
Ls
Ls
Ls
Ls
Ls
Ls
Ls
Ls
Ls
Ls
Ls
Ls
Ls
Ls
Ls
Ls
Ls
Ls
Ls
Ls
Ls
Ls
Ls
Ls
Ls
Ls
Ls
Ls
Ls
Ls
Ls
Ls
Ls
Ls
Ls
Ls
Ls
Ls
Ls
Ls
Ls
Ls
Ls
Ls
Ls
"}
(37,1,1) = {"
Ls
Ls
Ls
Ls
Ls
Ls
Ls
Ls
Ls
Ls
Ls
Ls
Ls
Ls
Ls
Ls
Ls
Ls
Ls
Ls
Ls
Ls
Ls
Ls
Ls
Ls
Ls
Ls
Ls
Ls
Ls
Ls
Ls
Ls
Ls
Ls
Ls
Ls
Ls
Ls
Ls
Ls
Ls
Ls
Ls
Ls
Ls
"}
