"a" = (/turf/unsimulated/wall,/area/crawler)
"b" = (/turf/simulated/floor/tiled/white/airless,/area/crawler)
"c" = (/obj/crawler/room_controller{roomnum = 1},/turf/simulated/floor/tiled/white/airless,/area/crawler)
"d" = (/obj/crawler/room_controller{room_x = 2; room_y = 1; roomnum = 2},/turf/simulated/floor/tiled/white/airless,/area/crawler)
"e" = (/obj/crawler/room_controller{room_x = 3; room_y = 1; roomnum = 3},/turf/simulated/floor/tiled/white/airless,/area/crawler)
"f" = (/obj/crawler/room_controller{room_x = 4; roomnum = 4},/turf/simulated/floor/tiled/white/airless,/area/crawler)
"g" = (/obj/crawler/room_controller{room_y = 2; roomnum = 5},/turf/simulated/floor/tiled/white/airless,/area/crawler)
"h" = (/obj/crawler/room_controller{room_x = 2; room_y = 2; roomnum = 6},/turf/simulated/floor/tiled/white/airless,/area/crawler)
"i" = (/obj/crawler/room_controller{room_x = 3; room_y = 2; roomnum = 7},/turf/simulated/floor/tiled/white/airless,/area/crawler)
"j" = (/obj/crawler/room_controller{room_x = 4; room_y = 2; roomnum = 8},/turf/simulated/floor/tiled/white/airless,/area/crawler)
"k" = (/obj/crawler/room_controller{room_y = 3; roomnum = 9},/turf/simulated/floor/tiled/white/airless,/area/crawler)
"l" = (/obj/crawler/room_controller{room_x = 2; room_y = 3; roomnum = 10},/turf/simulated/floor/tiled/white/airless,/area/crawler)
"m" = (/obj/crawler/room_controller{room_x = 3; room_y = 3; roomnum = 11},/turf/simulated/floor/tiled/white/airless,/area/crawler)
"n" = (/obj/crawler/room_controller{room_x = 4; room_y = 3; roomnum = 12},/turf/simulated/floor/tiled/white/airless,/area/crawler)
"o" = (/obj/crawler/room_controller{room_y = 4; roomnum = 13},/turf/simulated/floor/tiled/white/airless,/area/crawler)
"p" = (/obj/crawler/room_controller{room_x = 2; room_y = 4; roomnum = 14},/turf/simulated/floor/tiled/white/airless,/area/crawler)
"q" = (/obj/crawler/room_controller{room_x = 3; room_y = 4; roomnum = 15},/turf/simulated/floor/tiled/white/airless,/area/crawler)
"r" = (/obj/crawler/room_controller{room_x = 4; room_y = 4; roomnum = 16},/turf/simulated/floor/tiled/white/airless,/area/crawler)
"s" = (/obj/map_data/crawler,/obj/crawler/map_maker,/turf/unsimulated/wall,/area/crawler)

(1,1,1) = {"
saaaaaaaaaaaaaaaaaaaaaaaaaaaaaaaaaaaaaaaaaaaaaaaaaaaaa
abbbbbbbbbbbbbbbbbbbbbbbbbbbbbbbbbbbbbbbbbbbbbbbbbbbba
abbbbbbbbbbbbbbbbbbbbbbbbbbbbbbbbbbbbbbbbbbbbbbbbbbbba
abbbbbbbbbbbbbbbbbbbbbbbbbbbbbbbbbbbbbbbbbbbbbbbbbbbba
abbbbbbbbbbbbbbbbbbbbbbbbbbbbbbbbbbbbbbbbbbbbbbbbbbbba
abbbbbbcbbbbbbbbbbbbdbbbbbbbbbbbbebbbbbbbbbbbbfbbbbbba
abbbbbbbbbbbbbbbbbbbbbbbbbbbbbbbbbbbbbbbbbbbbbbbbbbbba
abbbbbbbbbbbbbbbbbbbbbbbbbbbbbbbbbbbbbbbbbbbbbbbbbbbba
abbbbbbbbbbbbbbbbbbbbbbbbbbbbbbbbbbbbbbbbbbbbbbbbbbbba
abbbbbbbbbbbbbbbbbbbbbbbbbbbbbbbbbbbbbbbbbbbbbbbbbbbba
abbbbbbbbbbbbbbbbbbbbbbbbbbbbbbbbbbbbbbbbbbbbbbbbbbbba
abbbbbbbbbbbbbbbbbbbbbbbbbbbbbbbbbbbbbbbbbbbbbbbbbbbba
abbbbbbbbbbbbbbbbbbbbbbbbbbbbbbbbbbbbbbbbbbbbbbbbbbbba
abbbbbbbbbbbbbbbbbbbbbbbbbbbbbbbbbbbbbbbbbbbbbbbbbbbba
abbbbbbgbbbbbbbbbbbbhbbbbbbbbbbbbibbbbbbbbbbbbjbbbbbba
abbbbbbbbbbbbbbbbbbbbbbbbbbbbbbbbbbbbbbbbbbbbbbbbbbbba
abbbbbbbbbbbbbbbbbbbbbbbbbbbbbbbbbbbbbbbbbbbbbbbbbbbba
abbbbbbbbbbbbbbbbbbbbbbbbbbbbbbbbbbbbbbbbbbbbbbbbbbbba
abbbbbbbbbbbbbbbbbbbbbbbbbbbbbbbbbbbbbbbbbbbbbbbbbbbba
abbbbbbbbbbbbbbbbbbbbbbbbbbbbbbbbbbbbbbbbbbbbbbbbbbbba
abbbbbbbbbbbbbbbbbbbbbbbbbbbbbbbbbbbbbbbbbbbbbbbbbbbba
abbbbbbbbbbbbbbbbbbbbbbbbbbbbbbbbbbbbbbbbbbbbbbbbbbbba
abbbbbbbbbbbbbbbbbbbbbbbbbbbbbbbbbbbbbbbbbbbbbbbbbbbba
abbbbbbkbbbbbbbbbbbblbbbbbbbbbbbbmbbbbbbbbbbbbnbbbbbba
abbbbbbbbbbbbbbbbbbbbbbbbbbbbbbbbbbbbbbbbbbbbbbbbbbbba
abbbbbbbbbbbbbbbbbbbbbbbbbbbbbbbbbbbbbbbbbbbbbbbbbbbba
abbbbbbbbbbbbbbbbbbbbbbbbbbbbbbbbbbbbbbbbbbbbbbbbbbbba
abbbbbbbbbbbbbbbbbbbbbbbbbbbbbbbbbbbbbbbbbbbbbbbbbbbba
abbbbbbbbbbbbbbbbbbbbbbbbbbbbbbbbbbbbbbbbbbbbbbbbbbbba
abbbbbbbbbbbbbbbbbbbbbbbbbbbbbbbbbbbbbbbbbbbbbbbbbbbba
abbbbbbbbbbbbbbbbbbbbbbbbbbbbbbbbbbbbbbbbbbbbbbbbbbbba
abbbbbbbbbbbbbbbbbbbbbbbbbbbbbbbbbbbbbbbbbbbbbbbbbbbba
abbbbbbobbbbbbbbbbbbpbbbbbbbbbbbbqbbbbbbbbbbbbrbbbbbba
abbbbbbbbbbbbbbbbbbbbbbbbbbbbbbbbbbbbbbbbbbbbbbbbbbbba
abbbbbbbbbbbbbbbbbbbbbbbbbbbbbbbbbbbbbbbbbbbbbbbbbbbba
abbbbbbbbbbbbbbbbbbbbbbbbbbbbbbbbbbbbbbbbbbbbbbbbbbbba
abbbbbbbbbbbbbbbbbbbbbbbbbbbbbbbbbbbbbbbbbbbbbbbbbbbba
aaaaaaaaaaaaaaaaaaaaaaaaaaaaaaaaaaaaaaaaaaaaaaaaaaaaaa
"}
