"a" = (/obj/spawner/junk/low_chance,/turf/simulated/floor/exoplanet/water/shallow/tar,/area/template_noop)
"b" = (/turf/template_noop,/area/template_noop)
"c" = (/obj/structure/flora/ausbushes/lavendergrass,/turf/template_noop,/area/template_noop)
"d" = (/obj/machinery/artifact,/turf/simulated/floor/exoplanet/shrouded,/area/template_noop)
"e" = (/obj/structure/flora/ausbushes/fullgrass,/turf/template_noop,/area/template_noop)
"f" = (/turf/simulated/floor/exoplanet/water/shallow/tar,/area/template_noop)
"g" = (/obj/spawner/toy/plushie,/turf/simulated/floor/exoplanet/water/shallow/tar,/area/template_noop)
"h" = (/obj/spawner/oddities,/turf/simulated/floor/exoplanet/water/shallow/tar,/area/template_noop)
"i" = (/obj/spawner/junk,/turf/simulated/floor/exoplanet/water/shallow/tar,/area/template_noop)

(1,1,1) = {"
fbbbcfffbbb
bbbffffffbf
bcfffffffcb
bfffafffffb
bfffffffffb
bffffdffgff
ffffffffffb
fffhfffiffb
fffffffffbb
efffffffcfb
bbffbbcbbbb
"}
