//MAP CONVERTED BY dmm2tgm.py THIS HEADER COMMENT PREVENTS RECONVERSION, DO NOT REMOVE
"a" = (
/turf/template_noop,
/area/template_noop)
"b" = (
/obj/effect/decal/cleanable/blood/drip,
/turf/template_noop,
/area/template_noop)
"c" = (
/obj/item/stack/rods,
/turf/template_noop,
/area/template_noop)
"d" = (
/obj/item/stack/rods,
/obj/item/stack/material/steel{
	amount = 50
	},
/turf/template_noop,
/area/template_noop)
"e" = (
/obj/item/stack/material/steel{
	amount = 50
	},
/turf/template_noop,
/area/template_noop)
"f" = (
/obj/structure/lattice,
/obj/item/stack/material/steel{
	amount = 50
	},
/obj/effect/damagedfloor,
/turf/template_noop,
/area/template_noop)
"g" = (
/turf/simulated/wall,
/area/map_template/marooned)
"h" = (
/obj/effect/decal/cleanable/dirt,
/turf/simulated/wall,
/area/map_template/marooned)
"i" = (
/obj/effect/damagedfloor,
/turf/template_noop,
/area/template_noop)
"j" = (
/obj/item/stack/material/steel{
	amount = 50
	},
/obj/effect/damagedfloor,
/turf/template_noop,
/area/template_noop)
"k" = (
/obj/machinery/computer,
/obj/effect/floor_decal/industrial/warning/full,
/turf/simulated/floor/tiled/steel/techfloor_grid,
/area/map_template/marooned)
"l" = (
/obj/effect/floor_decal/industrial/warning/corner{
	icon_state = "corner_white";
	dir = 9
	},
/obj/machinery/portable_atmospherics/canister/air,
/turf/simulated/floor/tiled/steel/techfloor,
/area/map_template/marooned)
"m" = (
/obj/landmark/corpse/marooned_officer,
/obj/structure/bed/chair{
	dir = 1
	},
/obj/effect/decal/cleanable/blood,
/obj/item/gun/projectile/revolver/medium,
/turf/simulated/floor/tiled/steel/techfloor_grid,
/area/map_template/marooned)
"n" = (
/obj/item/clothing/accessory/medal/silver/marooned_medal{
	desc = "A heart-shaped bronze medal. Has Magnitka flag at top part and engraved name - H. Warda.";
	name = "\improper Magnitka medal"
	},
/obj/structure/table/steel_reinforced,
/obj/effect/floor_decal/industrial/warning/corner{
	icon_state = "corner_white";
	dir = 6
	},
/obj/item/paper/marooned/note09,
/turf/simulated/floor/tiled/steel/techfloor,
/area/map_template/marooned)
"o" = (
/obj/structure/lattice,
/obj/effect/damagedfloor,
/turf/template_noop,
/area/template_noop)
"p" = (
/obj/item/paper/marooned/note02{
	pixel_x = -3;
	pixel_y = -5
	},
/obj/item/paper/marooned/note01{
	pixel_x = 2;
	pixel_y = -1
	},
/obj/structure/table/steel_reinforced,
/obj/effect/floor_decal/industrial/warning/corner{
	icon_state = "corner_white";
	dir = 9
	},
/turf/simulated/floor/tiled/steel/techfloor,
/area/map_template/marooned)
"q" = (
/obj/machinery/space_heater,
/obj/effect/decal/cleanable/blood/drip,
/turf/simulated/floor/tiled/steel/techfloor_grid,
/area/map_template/marooned)
"r" = (
/obj/item/paper/marooned/note03{
	pixel_x = 2;
	pixel_y = 2
	},
/obj/structure/table/steel_reinforced,
/obj/effect/floor_decal/industrial/warning/corner{
	icon_state = "corner_white";
	dir = 6
	},
/turf/simulated/floor/tiled/steel/techfloor,
/area/map_template/marooned)
"s" = (
/obj/machinery/door/airlock/centcom,
/turf/simulated/floor/tiled/steel/techfloor,
/area/map_template/marooned)
"t" = (
/obj/structure/closet/crate/freezer,
/obj/structure/railing{
	icon_state = "handrail";
	dir = 4
	},
/obj/effect/floor_decal/industrial/outline,
/turf/simulated/floor/tiled/steel/techfloor,
/area/map_template/marooned)
"u" = (
/obj/structure/closet/crate/freezer,
/obj/structure/railing,
/turf/simulated/floor/tiled/steel/techfloor_grid,
/area/map_template/marooned)
"v" = (
/obj/item/paper/marooned/note06,
/obj/spawner/junk,
/obj/item/paper/marooned/note08,
/turf/simulated/floor/tiled/steel/techfloor_grid,
/area/map_template/marooned)
"w" = (
/obj/machinery/space_heater,
/obj/structure/railing,
/turf/simulated/floor/tiled/steel/techfloor_grid,
/area/map_template/marooned)
"x" = (
/obj/machinery/suit_storage_unit/standard_unit,
/obj/effect/floor_decal/industrial/outline,
/turf/simulated/floor/tiled/steel/techfloor,
/area/map_template/marooned)
"y" = (
/obj/structure/closet/crate/freezer,
/obj/item/paper/marooned/note04,
/obj/item/paper/marooned/note05{
	pixel_x = -3;
	pixel_y = 1
	},
/obj/structure/railing{
	icon_state = "handrail";
	dir = 4
	},
/obj/effect/floor_decal/industrial/outline,
/turf/simulated/floor/tiled/steel/techfloor,
/area/map_template/marooned)
"z" = (
/obj/item/trash/liquidfood,
/obj/item/trash/liquidfood,
/obj/effect/decal/cleanable/blood/drip,
/turf/simulated/floor/tiled/steel/techfloor_grid,
/area/map_template/marooned)
"A" = (
/obj/spawner/junk,
/turf/simulated/floor/tiled/steel/techfloor_grid,
/area/map_template/marooned)
"B" = (
/obj/item/paper/marooned/note07{
	pixel_x = 6
	},
/obj/spawner/junk,
/obj/effect/decal/cleanable/blood/drip,
/obj/structure/bed,
/turf/simulated/floor/tiled/steel/techfloor_grid,
/area/map_template/marooned)
"C" = (
/obj/structure/shuttle/engine/propulsion,
/obj/effect/damagedfloor,
/turf/template_noop,
/area/template_noop)
"D" = (
/obj/structure/railing{
	icon_state = "handrail";
	dir = 4
	},
/obj/structure/bed/chair{
	icon_state = "chair_preview";
	dir = 4
	},
/obj/item/trash/liquidfood,
/obj/item/trash/liquidfood,
/obj/effect/floor_decal/industrial/outline,
/turf/simulated/floor/tiled/steel/techfloor,
/area/map_template/marooned)
"E" = (
/obj/item/trash/liquidfood,
/obj/item/trash/liquidfood,
/turf/simulated/floor/tiled/steel/techfloor_grid,
/area/map_template/marooned)
"F" = (
/mob/living/simple_animal/hostile/roomba/gun_ba,
/turf/simulated/floor/tiled/steel/techfloor_grid,
/area/map_template/marooned)
"G" = (
/turf/simulated/floor/tiled/steel/techfloor_grid,
/area/map_template/marooned)
"H" = (
/obj/structure/railing{
	icon_state = "handrail";
	dir = 4
	},
/obj/structure/bed/chair{
	icon_state = "chair_preview";
	dir = 4
	},
/obj/effect/floor_decal/industrial/outline,
/turf/simulated/floor/tiled/steel/techfloor,
/area/map_template/marooned)
"I" = (
/obj/item/tool/wirecutters,
/obj/item/stack/cable_coil,
/obj/machinery/power/port_gen/pacman/super,
/obj/structure/cable{
	icon_state = "0-5";
	dir = 8
	},
/turf/simulated/floor/tiled/steel/techfloor_grid,
/area/map_template/marooned)
"J" = (
/obj/effect/decal/cleanable/blood/drip,
/turf/simulated/floor/tiled/steel/techfloor_grid,
/area/map_template/marooned)
"L" = (
/obj/structure/inflatable/wall,
/obj/structure/railing{
	icon_state = "handrail";
	dir = 4
	},
/obj/effect/floor_decal/industrial/warning,
/turf/simulated/floor/tiled/dark,
/area/map_template/marooned)
"M" = (
/obj/structure/inflatable/door,
/obj/structure/cable{
	icon_state = "1-6";
	dir = 1
	},
/obj/effect/floor_decal/industrial/warning,
/turf/simulated/floor/tiled/steel/techfloor_grid,
/area/map_template/marooned)
"N" = (
/obj/structure/inflatable/wall,
/obj/structure/railing{
	icon_state = "handrail";
	dir = 8
	},
/obj/effect/floor_decal/industrial/warning,
/turf/simulated/floor/tiled/steel/techfloor_grid,
/area/map_template/marooned)
"O" = (
/obj/structure/inflatable/door,
/obj/structure/cable{
	icon_state = "2-5";
	dir = 1
	},
/obj/effect/floor_decal/industrial/warning,
/obj/machinery/door/airlock/centcom,
/turf/simulated/floor/tiled/steel/techfloor,
/area/map_template/marooned)
"P" = (
/obj/structure/fuel_port,
/obj/effect/decal/cleanable/dirt,
/turf/simulated/wall,
/area/map_template/marooned)
"Q" = (
/obj/structure/inflatable/wall,
/obj/structure/cable{
	icon_state = "2-5";
	dir = 2
	},
/obj/effect/damagedfloor,
/turf/template_noop,
/area/template_noop)
"R" = (
/obj/structure/inflatable/door,
/obj/effect/damagedfloor,
/turf/template_noop,
/area/template_noop)
"S" = (
/obj/structure/inflatable/wall,
/obj/effect/damagedfloor,
/turf/template_noop,
/area/template_noop)
"T" = (
/obj/structure/cable{
	icon_state = "2-5";
	dir = 1
	},
/obj/effect/damagedfloor,
/turf/template_noop,
/area/template_noop)
"U" = (
/turf/simulated/wall,
/area/template_noop)
"V" = (
/obj/effect/decal/cleanable/dirt,
/turf/simulated/wall,
/area/template_noop)
"W" = (
/obj/spawner/techpart,
/obj/item/material/wirerod{
	desc = "Metal rod with wire attached to it.";
	name = "Jurry-rigged antenna";
	pixel_x = 5;
	pixel_y = 3
	},
/obj/item/device/radio,
/obj/item/stack/cable_coil,
/obj/structure/cable{
	icon_state = "0-6";
	dir = 4
	},
/obj/structure/cable{
	icon_state = "0-4";
	d2 = 4
	},
/obj/effect/damagedfloor,
/turf/template_noop,
/area/template_noop)
"X" = (
/obj/structure/cable{
	d1 = 4;
	d2 = 8;
	icon_state = "4-8";
	pixel_x = 0
	},
/obj/effect/damagedfloor,
/turf/template_noop,
/area/template_noop)
"Y" = (
/obj/item/material/wirerod{
	desc = "Metal rod with wire attached to it.";
	name = "Jurry-rigged antenna";
	pixel_x = 5;
	pixel_y = 3
	},
/obj/structure/cable{
	d2 = 8;
	icon_state = "0-8"
	},
/obj/effect/damagedfloor,
/turf/template_noop,
/area/template_noop)
"Z" = (
/obj/effect/decal/cleanable/blood/drip,
/obj/effect/damagedfloor,
/turf/template_noop,
/area/template_noop)

(1,1,1) = {"
a
a
a
a
a
a
a
a
a
a
a
a
a
a
a
a
a
a
a
a
a
a
a
a
a
a
a
a
a
a
"}
(2,1,1) = {"
a
a
c
a
a
a
a
a
a
a
a
a
a
a
a
a
a
a
a
a
a
a
a
a
a
a
a
a
a
a
"}
(3,1,1) = {"
a
a
a
a
a
a
a
a
i
h
h
C
i
i
i
i
i
i
i
i
a
a
a
a
a
a
a
a
a
a
"}
(4,1,1) = {"
a
a
a
a
a
a
a
i
i
h
h
C
i
i
i
i
i
i
i
i
i
a
a
a
a
a
a
a
a
a
"}
(5,1,1) = {"
a
a
a
a
e
j
g
h
h
h
h
h
h
h
i
i
i
i
i
i
i
i
a
a
a
a
a
a
a
a
"}
(6,1,1) = {"
a
a
a
a
f
g
h
h
h
t
y
D
H
h
h
i
i
W
i
i
i
a
a
a
a
a
a
a
a
a
"}
(7,1,1) = {"
a
a
a
a
g
h
l
p
h
u
z
E
I
L
h
Q
T
X
i
i
i
a
a
a
a
a
a
a
a
a
"}
(8,1,1) = {"
a
a
a
a
h
k
m
q
s
v
A
F
J
M
O
R
i
X
i
i
i
a
a
a
a
a
a
a
a
a
"}
(9,1,1) = {"
a
a
a
a
h
h
n
r
h
w
B
G
G
N
h
S
i
X
i
i
i
i
a
a
a
a
a
a
a
a
"}
(10,1,1) = {"
a
a
a
a
g
h
h
h
h
x
x
x
x
h
P
i
i
X
i
i
i
i
a
a
a
a
a
a
a
a
"}
(11,1,1) = {"
a
a
a
a
i
i
o
h
h
h
h
h
h
h
i
i
i
X
Z
i
a
a
a
a
a
a
a
a
a
a
"}
(12,1,1) = {"
a
a
a
a
i
i
i
i
i
o
o
i
i
j
i
i
i
Y
i
i
a
a
a
a
a
a
a
a
a
a
"}
(13,1,1) = {"
a
a
a
a
i
i
i
i
j
i
i
i
i
i
b
a
a
a
a
a
a
a
a
a
a
a
a
a
a
a
"}
(14,1,1) = {"
a
a
a
a
a
a
i
i
i
i
i
i
a
a
a
a
a
a
a
a
a
a
a
a
a
a
a
c
a
a
"}
(15,1,1) = {"
a
a
a
d
a
a
a
a
a
a
a
a
a
a
a
a
a
a
a
a
a
a
a
a
a
a
a
a
a
a
"}
(16,1,1) = {"
a
a
a
a
a
a
a
a
a
a
a
a
a
a
a
a
a
e
a
a
a
a
a
a
a
a
a
a
a
a
"}
(17,1,1) = {"
a
a
a
a
a
a
a
a
a
a
a
a
a
a
a
a
c
c
a
a
a
a
a
a
a
a
a
a
a
a
"}
(18,1,1) = {"
a
a
a
a
a
a
a
a
c
a
a
a
a
a
a
a
a
a
a
a
a
a
a
a
a
a
a
a
a
a
"}
(19,1,1) = {"
a
a
a
a
a
a
a
a
b
a
a
a
a
a
a
a
a
a
a
a
e
a
a
a
a
a
a
a
a
a
"}
(20,1,1) = {"
a
a
a
a
a
a
a
a
a
a
a
a
a
a
a
a
a
a
a
a
a
a
a
a
a
a
a
a
a
a
"}
(21,1,1) = {"
a
a
a
a
a
a
a
a
a
a
a
a
a
a
e
a
a
a
a
a
a
a
a
a
a
a
a
a
a
a
"}
(22,1,1) = {"
a
a
a
a
a
a
e
a
a
a
a
a
a
a
a
a
a
a
a
a
a
a
a
a
a
a
a
c
a
a
"}
(23,1,1) = {"
a
a
a
a
a
a
a
a
a
a
a
a
a
a
a
a
a
a
a
a
a
a
a
a
a
a
a
a
a
a
"}
(24,1,1) = {"
a
b
a
a
a
a
a
c
a
a
a
a
a
a
a
a
a
a
a
a
a
a
a
a
a
a
a
a
a
a
"}
(25,1,1) = {"
a
a
a
a
a
a
a
a
a
a
a
a
a
a
a
a
i
i
a
a
a
a
a
a
a
a
a
a
a
a
"}
(26,1,1) = {"
a
a
a
a
a
a
a
a
a
a
a
a
a
a
a
i
i
i
i
a
a
a
a
a
a
a
a
a
a
a
"}
(27,1,1) = {"
a
a
a
c
a
a
a
a
a
a
a
a
a
a
i
i
U
V
C
a
a
a
a
a
a
a
a
a
a
a
"}
(28,1,1) = {"
a
a
a
a
a
a
a
a
a
a
a
a
a
a
i
i
V
V
C
a
a
a
a
a
a
a
a
a
a
a
"}
(29,1,1) = {"
a
a
a
a
a
a
a
a
a
a
a
a
a
a
a
i
i
i
a
a
a
a
a
a
a
a
c
a
a
a
"}
(30,1,1) = {"
a
a
a
a
a
a
a
a
a
a
a
a
a
a
a
a
a
a
a
a
a
a
a
a
a
a
a
a
a
a
"}
