//MAP CONVERTED BY dmm2tgm.py THIS HEADER COMMENT PREVENTS RECONVERSION, DO NOT REMOVE
"aa" = (
/turf/shuttle/wall{
	icon_state = "wall3"
	},
/area/map_template/oldpod)
"ab" = (
/obj/structure/shuttle/engine/propulsion{
	dir = 1
	},
/turf/floor/plating,
/area/map_template/oldpod)
"ad" = (
/turf/floor/plating,
/area/map_template/oldpod)
"ae" = (
/obj/machinery/door/firedoor,
/turf/floor/plating,
/area/map_template/oldpod)
"ag" = (
/obj/structure/shuttle/engine/heater{
	dir = 1;
	icon_state = "heater"
	},
/turf/floor/plating,
/area/map_template/oldpod)
"ah" = (
/obj/effect/floor_decal/industrial/outline/yellow,
/obj/machinery/portable_atmospherics/canister/air/airlock,
/obj/structure/window/reinforced{
	dir = 8
	},
/obj/effect/decal/cleanable/dirt,
/turf/floor/plating,
/area/map_template/oldpod)
"ai" = (
/obj/effect/decal/cleanable/dirt,
/obj/effect/decal/cleanable/dirt,
/turf/floor/tiled/steel/techfloor,
/area/map_template/oldpod)
"aj" = (
/obj/effect/floor_decal/industrial/outline/yellow,
/obj/machinery/portable_atmospherics/canister/empty,
/obj/structure/window/reinforced{
	dir = 4
	},
/turf/floor/plating,
/area/map_template/oldpod)
"ak" = (
/obj/structure/bed,
/obj/landmark/corpse/doctor,
/obj/effect/decal/cleanable/blood,
/obj/effect/decal/cleanable/dirt,
/turf/floor/tiled/steel/techfloor,
/area/map_template/oldpod)
"al" = (
/obj/structure/bed,
/obj/effect/decal/cleanable/dirt,
/obj/effect/decal/cleanable/dirt,
/obj/effect/decal/cleanable/dirt,
/turf/floor/tiled/steel/techfloor,
/area/map_template/oldpod)
"am" = (
/obj/effect/decal/cleanable/dirt,
/obj/effect/decal/cleanable/dirt,
/obj/effect/decal/cleanable/dirt,
/turf/floor/tiled/steel/techfloor,
/area/map_template/oldpod)
"an" = (
/obj/effect/decal/cleanable/blood,
/obj/effect/decal/cleanable/dirt,
/turf/floor/tiled/steel/techfloor,
/area/map_template/oldpod)
"ao" = (
/obj/structure/bed/chair/shuttle{
	dir = 8;
	icon_state = "shuttle_chair_preview"
	},
/obj/structure/window/reinforced{
	dir = 4
	},
/obj/effect/decal/cleanable/dirt,
/turf/floor/tiled/steel/techfloor,
/area/map_template/oldpod)
"ap" = (
/obj/structure/bed/chair/shuttle{
	dir = 4;
	icon_state = "shuttle_chair_preview"
	},
/obj/structure/window/reinforced{
	dir = 8
	},
/obj/effect/decal/cleanable/dirt,
/turf/floor/tiled/steel/techfloor,
/area/map_template/oldpod)
"aq" = (
/obj/structure/closet/wall_mounted/firecloset{
	pixel_x = 24;
	pixel_y = 0
	},
/obj/effect/decal/cleanable/blood/drip,
/obj/effect/decal/cleanable/dirt,
/obj/effect/decal/cleanable/dirt,
/obj/effect/decal/cleanable/dirt,
/turf/floor/tiled/steel/techfloor,
/area/map_template/oldpod)
"ar" = (
/obj/machinery/light/small{
	dir = 8
	},
/obj/effect/decal/cleanable/dirt,
/obj/effect/decal/cleanable/dirt,
/turf/floor/tiled/steel/techfloor,
/area/map_template/oldpod)
"at" = (
/obj/effect/decal/cleanable/blood/drip,
/obj/effect/decal/cleanable/blood,
/obj/effect/decal/cleanable/dirt,
/obj/effect/decal/cleanable/dirt,
/turf/floor/tiled/steel/techfloor,
/area/map_template/oldpod)
"aw" = (
/obj/machinery/light/small{
	dir = 4
	},
/obj/effect/decal/cleanable/dirt,
/obj/effect/decal/cleanable/dirt,
/obj/effect/decal/cleanable/dirt,
/turf/floor/tiled/steel/techfloor,
/area/map_template/oldpod)
"ax" = (
/obj/machinery/door/firedoor,
/obj/effect/decal/cleanable/dirt,
/turf/floor/plating,
/area/map_template/oldpod)
"ay" = (
/obj/item/frame/air_alarm,
/obj/effect/decal/cleanable/dirt,
/obj/effect/decal/cleanable/dirt,
/obj/item/electronics/airalarm,
/turf/floor/tiled/steel/techfloor,
/area/map_template/oldpod)
"az" = (
/obj/effect/decal/cleanable/blood/drip,
/obj/effect/decal/cleanable/dirt,
/obj/effect/decal/cleanable/dirt,
/obj/effect/decal/cleanable/dirt,
/turf/floor/tiled/steel/techfloor,
/area/map_template/oldpod)
"aA" = (
/obj/spawner/firstaid,
/obj/effect/decal/cleanable/dirt,
/obj/effect/decal/cleanable/dirt,
/obj/effect/decal/cleanable/dirt,
/obj/effect/decal/cleanable/dirt,
/turf/floor/tiled/steel/techfloor,
/area/map_template/oldpod)
"aB" = (
/obj/effect/decal/cleanable/blood/drip,
/obj/effect/decal/cleanable/dirt,
/obj/effect/decal/cleanable/dirt,
/obj/effect/decal/cleanable/dirt,
/obj/effect/decal/cleanable/dirt,
/obj/effect/decal/cleanable/dirt,
/turf/floor/tiled/steel/techfloor,
/area/map_template/oldpod)
"aC" = (
/obj/item/clothing/suit/space,
/obj/item/clothing/head/space,
/obj/effect/decal/cleanable/dirt,
/obj/effect/decal/cleanable/dirt,
/turf/floor/tiled/steel/techfloor,
/area/map_template/oldpod)
"aD" = (
/obj/structure/window/reinforced{
	dir = 1
	},
/obj/structure/table/standard{
	name = "plastic table frame"
	},
/obj/spawner/pack/tech_loot,
/obj/spawner/pack/tech_loot,
/obj/spawner/pack/tech_loot,
/obj/spawner/pack/tech_loot,
/obj/spawner/pack/tech_loot,
/obj/item/tool/pickaxe,
/obj/effect/decal/cleanable/dirt,
/turf/floor/tiled/steel/techfloor,
/area/map_template/oldpod)
"aE" = (
/obj/structure/window/reinforced{
	dir = 1
	},
/obj/effect/decal/cleanable/dirt,
/obj/structure/table,
/turf/floor/tiled/steel/techfloor,
/area/map_template/oldpod)
"aG" = (
/obj/effect/decal/cleanable/blood/drip,
/obj/effect/decal/cleanable/blood,
/obj/effect/decal/cleanable/dirt,
/turf/floor/tiled/steel/techfloor,
/area/map_template/oldpod)
"aH" = (
/obj/item/frame/apc,
/obj/effect/decal/cleanable/dirt,
/obj/item/cell/small,
/obj/item/gun_upgrade/mechanism/battery_shunt,
/turf/floor/tiled/steel/techfloor,
/area/map_template/oldpod)
"aJ" = (
/obj/landmark/corpse/pirate,
/obj/item/gun/energy/retro,
/obj/effect/decal/cleanable/dirt,
/obj/effect/decal/cleanable/dirt,
/turf/floor/tiled/steel/techfloor,
/area/map_template/oldpod)
"aK" = (
/obj/effect/decal/cleanable/blood/drip,
/obj/effect/decal/cleanable/dirt,
/turf/floor/tiled/steel/techfloor,
/area/map_template/oldpod)
"aL" = (
/obj/effect/decal/cleanable/blood/drip,
/obj/effect/decal/cleanable/blood/drip,
/obj/effect/decal/cleanable/dirt,
/obj/effect/decal/cleanable/dirt,
/obj/effect/decal/cleanable/dirt,
/obj/effect/decal/cleanable/dirt,
/turf/floor/tiled/steel/techfloor,
/area/map_template/oldpod)
"aM" = (
/obj/landmark/corpse/scientist,
/obj/item/material/wirerod,
/obj/item/material/shard,
/obj/effect/decal/cleanable/blood,
/obj/effect/decal/cleanable/dirt,
/turf/floor/tiled/steel/techfloor,
/area/map_template/oldpod)
"aN" = (
/obj/machinery/door/firedoor,
/obj/structure/grille,
/obj/item/stack/rods,
/obj/item/stack/rods,
/obj/item/stack/rods,
/obj/item/stack/rods,
/obj/item/material/shard,
/obj/item/material/shard,
/obj/item/material/shard,
/obj/item/material/shard,
/turf/floor/plating,
/area/map_template/oldpod)
"aO" = (
/obj/machinery/door/airlock/external{
	name = "escape pod airlock"
	},
/turf/floor/plating,
/area/map_template/oldpod)
"aP" = (
/obj/effect/floor_decal/industrial/outline/yellow,
/obj/machinery/light/small{
	dir = 8
	},
/obj/effect/floor_decal/industrial/warning{
	dir = 5;
	icon_state = "warning"
	},
/obj/machinery/power/smes/buildable,
/turf/floor/plating,
/area/map_template/oldpod)
"aQ" = (
/obj/effect/decal/cleanable/dirt,
/turf/floor/tiled/steel/techfloor,
/area/map_template/oldpod)
"aR" = (
/obj/effect/floor_decal/industrial/warning{
	dir = 9;
	icon_state = "warning"
	},
/obj/structure/window/reinforced{
	dir = 8
	},
/obj/structure/window/reinforced{
	dir = 1
	},
/obj/structure/table/standard{
	name = "plastic table frame"
	},
/obj/item/storage/firstaid/surgery,
/obj/effect/decal/cleanable/dirt,
/turf/floor/tiled/white/techfloor,
/area/map_template/oldpod)
"aS" = (
/obj/effect/floor_decal/industrial/warning{
	dir = 1
	},
/obj/effect/decal/cleanable/dirt,
/obj/effect/decal/cleanable/dirt,
/obj/effect/decal/cleanable/dirt,
/turf/floor/tiled/white/techfloor,
/area/map_template/oldpod)
"aT" = (
/obj/effect/floor_decal/industrial/warning{
	dir = 5;
	icon_state = "warning"
	},
/obj/structure/window/reinforced{
	dir = 1
	},
/obj/structure/closet/crate/freezer/rations,
/obj/effect/decal/cleanable/dirt,
/obj/item/gun/projectile/shotgun/doublebarrel/sawn,
/obj/item/clothing/glasses/eyepatch,
/obj/item/melee/energy/sword/pirate,
/turf/floor/tiled/white/techfloor,
/area/map_template/oldpod)
"aU" = (
/obj/effect/floor_decal/industrial/warning{
	dir = 9
	},
/turf/floor/plating,
/area/map_template/oldpod)
"aV" = (
/obj/effect/floor_decal/industrial/warning{
	dir = 5
	},
/obj/machinery/light/small{
	dir = 4
	},
/obj/item/clothing/head/space,
/turf/floor/plating,
/area/map_template/oldpod)
"aW" = (
/obj/effect/floor_decal/industrial/warning{
	dir = 4
	},
/obj/structure/closet/crate,
/obj/item/tank/oxygen,
/turf/floor/plating,
/area/map_template/oldpod)
"aX" = (
/obj/effect/floor_decal/industrial/warning{
	dir = 8
	},
/obj/structure/window/reinforced{
	dir = 8
	},
/obj/machinery/optable,
/obj/effect/decal/cleanable/dirt,
/obj/effect/decal/cleanable/dirt,
/obj/effect/decal/cleanable/blood,
/turf/floor/tiled/white/techfloor,
/area/map_template/oldpod)
"aY" = (
/obj/effect/decal/cleanable/dirt,
/obj/effect/decal/cleanable/dirt,
/obj/effect/decal/cleanable/dirt,
/obj/effect/decal/cleanable/dirt,
/turf/floor/tiled/white/techfloor,
/area/map_template/oldpod)
"aZ" = (
/obj/machinery/sleeper{
	dir = 8
	},
/obj/effect/floor_decal/industrial/warning{
	dir = 4
	},
/obj/machinery/light/small{
	dir = 4
	},
/obj/effect/decal/cleanable/dirt,
/turf/floor/tiled/white/techfloor,
/area/map_template/oldpod)
"ba" = (
/obj/effect/floor_decal/industrial/warning{
	dir = 10
	},
/obj/item/clothing/suit/space,
/turf/floor/plating,
/area/map_template/oldpod)
"bb" = (
/obj/effect/floor_decal/industrial/warning{
	dir = 6
	},
/turf/floor/plating,
/area/map_template/oldpod)
"bc" = (
/obj/machinery/power/port_gen/pacman,
/obj/effect/floor_decal/industrial/warning{
	dir = 4
	},
/turf/floor/plating,
/area/map_template/oldpod)
"bd" = (
/obj/landmark/corpse/bridgeofficer,
/obj/effect/decal/cleanable/blood,
/turf/floor/tiled/steel/techfloor,
/area/map_template/oldpod)
"be" = (
/obj/effect/floor_decal/industrial/warning{
	dir = 10;
	icon_state = "warning"
	},
/obj/structure/window/reinforced{
	dir = 8
	},
/obj/structure/table/standard{
	name = "plastic table frame"
	},
/obj/spawner/firstaid,
/obj/spawner/firstaid,
/obj/effect/decal/cleanable/dirt,
/turf/floor/tiled/white/techfloor,
/area/map_template/oldpod)
"bf" = (
/obj/effect/floor_decal/industrial/warning,
/obj/effect/decal/cleanable/dirt,
/obj/effect/decal/cleanable/dirt,
/obj/effect/decal/cleanable/dirt,
/turf/floor/tiled/white/techfloor,
/area/map_template/oldpod)
"bg" = (
/obj/machinery/sleeper{
	dir = 8
	},
/obj/effect/floor_decal/industrial/warning{
	dir = 6;
	icon_state = "warning"
	},
/obj/effect/decal/cleanable/dirt,
/obj/effect/decal/cleanable/dirt,
/obj/effect/decal/cleanable/dirt,
/turf/floor/tiled/white/techfloor,
/area/map_template/oldpod)
"jX" = (
/mob/living/simple_animal/hostile/roomba/slayer,
/turf/floor/plating,
/area/map_template/oldpod)

(1,1,1) = {"
aa
aa
aa
aa
ax
ae
aa
aa
aa
aa
"}
(2,1,1) = {"
ab
ag
ak
ar
ay
aG
jX
aU
ba
aa
"}
(3,1,1) = {"
aa
aa
al
am
az
am
aO
aV
bb
aO
"}
(4,1,1) = {"
aa
ah
al
at
aA
aH
aa
aa
aa
aa
"}
(5,1,1) = {"
jX
ai
am
am
aB
am
aP
aW
bc
ad
"}
(6,1,1) = {"
ae
ai
an
ai
aC
aJ
aQ
aK
bd
ae
"}
(7,1,1) = {"
aa
aj
ao
ao
aD
aK
aR
aX
be
aa
"}
(8,1,1) = {"
aa
aa
ap
ap
aE
aL
aS
aY
bf
aa
"}
(9,1,1) = {"
ab
ag
aq
aw
ai
aM
aT
aZ
bg
aa
"}
(10,1,1) = {"
aa
aa
aa
aa
ae
aN
aa
aa
aa
aa
"}
