"a" = (/obj/structure/lattice,/turf/space,/area/space)
"b" = (/turf/space,/area/template_noop)
"c" = (/obj/structure/lattice,/turf/space,/area/template_noop)
"d" = (/obj/effect/window_lwall_spawn/smartspawn,/turf/simulated/floor/plating,/area/template_noop)
"e" = (/turf/simulated/wall/r_wall,/area/template_noop)

(1,1,1) = {"
aaaaa
abcba
adeba
accca
aaaaa
"}
