//MAP CONVERTED BY dmm2tgm.py THIS HEADER COMMENT PREVENTS RECONVERSION, DO NOT REMOVE
"a" = (
/turf/simulated/wall,
/area/crawler)
"b" = (
/obj/crawler/crawler_wallbreaker,
/turf/simulated/wall,
/area/crawler)
"c" = (
/turf/simulated/floor/tiled/derelict,
/area/crawler)
"d" = (
/turf/simulated/floor/carpet,
/area/crawler)
"e" = (
/obj/crawler/crawler_wallbreaker/vertical,
/turf/simulated/wall,
/area/crawler)
"f" = (
/obj/rogue/telebeacon,
/turf/simulated/floor/carpet,
/area/crawler)
"g" = (
/obj/structure/closet/onestar/tier3/normal,
/turf/simulated/floor/tiled/derelict,
/area/crawler)
"h" = (
/obj/structure/closet/onestar/tier2/normal,
/turf/simulated/floor/tiled/derelict,
/area/crawler)
"i" = (
/mob/living/simple_animal/hostile/megafauna/one_star,
/turf/simulated/floor/tiled/derelict,
/area/crawler)
"j" = (
/obj/structure/closet/onestar/tier3/special,
/turf/simulated/floor/tiled/derelict,
/area/crawler)
"k" = (
/obj/structure/closet/onestar/tier2/mineral,
/turf/simulated/floor/tiled/derelict,
/area/crawler)
"l" = (
/obj/machinery/light,
/turf/simulated/floor/tiled/derelict,
/area/crawler)
"u" = (
/obj/structure/sign/directions/evac{
	dir = 8
	},
/turf/simulated/wall,
/area/crawler)
"x" = (
/obj/structure/sign/directions/evac{
	dir = 1
	},
/turf/simulated/wall,
/area/crawler)
"A" = (
/obj/structure/sign/directions/evac,
/turf/simulated/wall,
/area/crawler)
"C" = (
/obj/structure/sign/directions/evac{
	dir = 4
	},
/turf/simulated/wall,
/area/crawler)

(1,1,1) = {"
a
a
a
C
e
C
a
a
a
"}
(2,1,1) = {"
a
c
c
c
c
c
c
c
a
"}
(3,1,1) = {"
a
c
g
c
c
c
j
c
a
"}
(4,1,1) = {"
a
c
c
c
c
c
c
c
a
"}
(5,1,1) = {"
a
c
c
c
c
c
c
c
a
"}
(6,1,1) = {"
A
c
d
d
d
d
d
c
x
"}
(7,1,1) = {"
b
c
d
i
f
c
d
l
b
"}
(8,1,1) = {"
A
c
d
c
d
c
d
c
x
"}
(9,1,1) = {"
a
c
c
c
c
c
c
c
a
"}
(10,1,1) = {"
a
c
c
c
c
c
c
c
a
"}
(11,1,1) = {"
a
c
h
c
c
c
k
c
a
"}
(12,1,1) = {"
a
c
c
c
c
c
c
c
a
"}
(13,1,1) = {"
a
a
a
u
e
u
a
a
a
"}
