//MAP CONVERTED BY dmm2tgm.py THIS HEADER COMMENT PREVENTS RECONVERSION, DO NOT REMOVE
"ag" = (
/obj/structure/girder,
/turf/floor/plating/under/airless,
/area/template_noop)
"ah" = (
/turf/floor/plating/under/airless,
/area/template_noop)
"an" = (
/obj/structure/window/reinforced{
	dir = 4
	},
/obj/structure/bed/chair/office/dark,
/obj/structure/barricade,
/obj/effect/decal/cleanable/blood/drip,
/turf/floor/tiled/dark/brown_platform/airless,
/area/template_noop)
"ao" = (
/obj/structure/window/reinforced{
	dir = 8
	},
/obj/item/remains/human,
/turf/floor/tiled/dark/brown_platform/airless,
/area/template_noop)
"as" = (
/obj/machinery/vending/cola,
/turf/floor/tiled/derelict/airless,
/area/template_noop)
"au" = (
/obj/structure/railing/grey{
	dir = 8
	},
/obj/machinery/light/floor,
/turf/floor/dirt/airless,
/area/template_noop)
"ax" = (
/obj/structure/sign/faction/one_star,
/turf/wall/untinted/onestar,
/area/template_noop)
"ay" = (
/obj/structure/railing/grey,
/obj/machinery/light/floor,
/turf/floor/dirt/airless,
/area/template_noop)
"aA" = (
/obj/machinery/light{
	dir = 1
	},
/turf/floor/tiled/derelict/white_small_edges/airless,
/area/template_noop)
"aJ" = (
/obj/structure/noticeboard,
/turf/wall/untinted/onestar_reinforced,
/area/template_noop)
"aK" = (
/obj/machinery/door/airlock/sandstone{
	name = "OneStar Airlock"
	},
/turf/floor/tiled/derelict/airless,
/area/template_noop)
"aN" = (
/turf/floor/tiled/techmaint/airless,
/area/template_noop)
"aQ" = (
/obj/spawner/scrap/sparse,
/turf/floor/plating/under/airless,
/area/template_noop)
"aR" = (
/obj/effect/floor_decal/industrial/loading,
/turf/floor/tiled/techmaint_cargo/airless,
/area/template_noop)
"aT" = (
/obj/effect/floor_decal/industrial/outline,
/turf/floor/tiled/techmaint_cargo/airless,
/area/template_noop)
"aU" = (
/obj/structure/bed/chair/custom/onestar{
	dir = 8
	},
/turf/floor/tiled/derelict/red_white_edges/airless,
/area/template_noop)
"bb" = (
/obj/structure/sink{
	dir = 8;
	pixel_x = -11
	},
/obj/structure/mirror{
	dir = 8;
	pixel_x = -28
	},
/turf/floor/tiled/cafe/airless,
/area/template_noop)
"bd" = (
/obj/machinery/light_construct{
	dir = 8
	},
/turf/floor/tiled/cafe/airless,
/area/template_noop)
"bl" = (
/obj/structure/sign/faction/one_star_old,
/turf/wall/untinted/onestar_reinforced,
/area/template_noop)
"bm" = (
/turf/floor/tiled/derelict/red_white_edges/airless,
/area/template_noop)
"bq" = (
/obj/spawner/scrap/sparse,
/turf/floor/tiled/derelict/white_small_edges/airless,
/area/template_noop)
"bs" = (
/obj/structure/closet/onestar/tier2,
/turf/floor/tiled/derelict/red_white_edges/airless,
/area/template_noop)
"bt" = (
/obj/structure/table/onestar,
/obj/item/paper_bin,
/obj/item/pen,
/turf/floor/tiled/derelict/red_white_edges/airless,
/area/template_noop)
"bu" = (
/obj/spawner/scrap/sparse,
/turf/floor/tiled/derelict/white_red_edges/airless,
/area/template_noop)
"bv" = (
/obj/machinery/light/floor,
/obj/item/remains/human,
/turf/floor/tiled/dark/brown_platform/airless,
/area/template_noop)
"by" = (
/obj/structure/sign/derelict3{
	pixel_y = 32
	},
/turf/floor/tiled/derelict/airless,
/area/template_noop)
"bE" = (
/turf/floor/dirt/airless,
/area/template_noop)
"bG" = (
/obj/structure/window/reinforced{
	dir = 8
	},
/obj/structure/table/onestar,
/obj/item/stamp/denied,
/obj/item/pen,
/turf/floor/tiled/dark/brown_perforated/airless,
/area/template_noop)
"bN" = (
/turf/wall/untinted/onestar,
/area/template_noop)
"co" = (
/obj/structure/window/reinforced{
	dir = 6
	},
/obj/structure/window/reinforced{
	dir = 4
	},
/obj/structure/table/onestar,
/obj/item/remains/human,
/obj/item/pen,
/turf/floor/tiled/dark/brown_perforated/airless,
/area/template_noop)
"cK" = (
/mob/living/simple_animal/hostile/roomba/gun_ba,
/turf/floor/tiled/derelict/red_white_edges/airless,
/area/template_noop)
"dO" = (
/obj/structure/table/onestar,
/obj/structure/window/reinforced{
	dir = 8
	},
/obj/item/folder/red,
/turf/floor/tiled/dark/techfloor/airless,
/area/template_noop)
"eD" = (
/obj/structure/closet/secure_closet/medicine,
/turf/floor/tiled/derelict/red_white_edges/airless,
/area/template_noop)
"fa" = (
/mob/living/simple_animal/hostile/roomba/slayer,
/turf/floor/tiled/derelict/white_small_edges/airless,
/area/template_noop)
"fy" = (
/obj/structure/toilet{
	dir = 8
	},
/obj/machinery/light{
	dir = 1
	},
/turf/floor/tiled/cafe/airless,
/area/template_noop)
"gK" = (
/obj/machinery/light{
	dir = 4
	},
/turf/floor/tiled/derelict/airless,
/area/template_noop)
"ib" = (
/obj/structure/table/onestar,
/turf/floor/tiled/dark/techfloor/airless,
/area/template_noop)
"ju" = (
/obj/structure/sign/derelict1{
	pixel_x = 32
	},
/turf/floor/tiled/derelict/airless,
/area/template_noop)
"jG" = (
/obj/spawner/scrap/dense,
/turf/floor/dirt/airless,
/area/template_noop)
"kb" = (
/obj/structure/window/reinforced{
	dir = 6
	},
/obj/structure/table/onestar,
/obj/item/clothing/accessory/medal/conduct,
/turf/floor/tiled/dark/brown_perforated/airless,
/area/template_noop)
"ku" = (
/obj/effect/floor_decal/industrial/outline/yellow,
/turf/floor/tiled/techmaint_cargo/airless,
/area/template_noop)
"kx" = (
/obj/spawner/junk,
/obj/structure/table/onestar,
/turf/floor/tiled/derelict/white_small_edges/airless,
/area/template_noop)
"kF" = (
/obj/structure/window/reinforced{
	dir = 4
	},
/obj/structure/bed/chair/office/dark{
	dir = 8
	},
/obj/item/pen,
/turf/floor/tiled/dark/brown_platform/airless,
/area/template_noop)
"lj" = (
/mob/living/simple_animal/hostile/roomba/boomba,
/turf/floor/tiled/derelict/white_red_edges/airless,
/area/template_noop)
"mJ" = (
/obj/spawner/junk,
/turf/floor/tiled/cafe/airless,
/area/template_noop)
"nC" = (
/obj/item/pen,
/turf/floor/tiled/dark/brown_platform/airless,
/area/template_noop)
"nF" = (
/obj/effect/floor_decal/industrial/warning,
/obj/effect/floor_decal/industrial/warning{
	dir = 1
	},
/obj/machinery/light{
	dir = 8
	},
/turf/floor/tiled/derelict/airless,
/area/template_noop)
"nI" = (
/obj/effect/floor_decal/industrial/loading{
	dir = 1
	},
/turf/floor/tiled/techmaint_cargo/airless,
/area/template_noop)
"nR" = (
/obj/structure/window/reinforced{
	dir = 1
	},
/obj/structure/window/reinforced{
	dir = 4
	},
/obj/structure/table/onestar,
/obj/item/modular_computer/laptop,
/turf/floor/tiled/dark/brown_perforated/airless,
/area/template_noop)
"oc" = (
/obj/effect/floor_decal/industrial/danger,
/turf/floor/tiled/derelict/white_small_edges/airless,
/area/template_noop)
"pa" = (
/obj/structure/window/reinforced{
	dir = 4
	},
/obj/structure/table/onestar,
/obj/item/stamp/chameleon,
/turf/floor/tiled/dark/brown_perforated/airless,
/area/template_noop)
"pb" = (
/obj/structure/cyberplant{
	desc = "One of those famous OneStar holoplants! Add to your Space a bit of the comfort from old Earth, by buying this blue buddy. A nuclear battery and a rugged case guarantee that your flower will survive journey to another galaxy, and variety of plant types won't let you to get bored along the way!";
	name = "OneStar \"Iridescent\""
	},
/turf/floor/tiled/cafe/airless,
/area/template_noop)
"pS" = (
/obj/item/remains/human,
/obj/item/clothing/accessory/blue,
/turf/floor/tiled/dark/brown_platform/airless,
/area/template_noop)
"qp" = (
/obj/structure/window/reinforced{
	dir = 4
	},
/obj/machinery/light/floor,
/obj/item/remains/human,
/obj/machinery/light{
	dir = 1
	},
/turf/floor/tiled/dark/brown_platform/airless,
/area/template_noop)
"qw" = (
/obj/structure/window/reinforced{
	dir = 4
	},
/obj/structure/window/reinforced{
	dir = 6
	},
/obj/structure/table/onestar,
/obj/item/device/lighting/toggleable/lamp,
/turf/floor/tiled/dark/brown_perforated/airless,
/area/template_noop)
"rb" = (
/obj/structure/table/onestar,
/turf/floor/tiled/derelict/red_white_edges/airless,
/area/template_noop)
"sB" = (
/obj/structure/reagent_dispensers/water_cooler,
/turf/floor/tiled/derelict/airless,
/area/template_noop)
"sD" = (
/obj/structure/window/reinforced{
	dir = 6
	},
/obj/structure/bed/chair/office/dark{
	dir = 4
	},
/obj/item/remains/human,
/turf/floor/tiled/dark/brown_platform/airless,
/area/template_noop)
"tl" = (
/obj/effect/floor_decal/industrial/warning{
	dir = 1
	},
/turf/floor/tiled/derelict/airless,
/area/template_noop)
"up" = (
/obj/machinery/light_construct,
/turf/floor/tiled/derelict/white_small_edges/airless,
/area/template_noop)
"uQ" = (
/obj/spawner/scrap/sparse,
/turf/floor/tiled/cafe/airless,
/area/template_noop)
"vG" = (
/obj/spawner/junkfood/rotten,
/turf/floor/tiled/derelict/white_small_edges/airless,
/area/template_noop)
"vL" = (
/obj/structure/window/reinforced{
	dir = 1
	},
/turf/floor/tiled/dark/brown_platform/airless,
/area/template_noop)
"wg" = (
/obj/machinery/light,
/turf/floor/tiled/derelict/red_white_edges/airless,
/area/template_noop)
"wF" = (
/obj/spawner/junk,
/turf/floor/dirt/airless,
/area/template_noop)
"xc" = (
/obj/structure/window/reinforced{
	dir = 8
	},
/obj/item/clothing/accessory/red,
/turf/floor/tiled/dark/brown_platform/airless,
/area/template_noop)
"xf" = (
/obj/structure/table/onestar,
/obj/structure/window/reinforced{
	dir = 4
	},
/obj/item/folder/red,
/turf/floor/tiled/dark/techfloor/airless,
/area/template_noop)
"yJ" = (
/obj/structure/window/reinforced{
	dir = 8
	},
/obj/structure/bed/chair/office/dark{
	dir = 4
	},
/turf/floor/tiled/dark/brown_platform/airless,
/area/template_noop)
"zc" = (
/obj/spawner/scrap/dense,
/turf/floor/tiled/derelict/white_red_edges/airless,
/area/template_noop)
"zj" = (
/obj/structure/window/reinforced{
	dir = 4
	},
/obj/structure/table/onestar,
/obj/item/device/taperecorder,
/turf/floor/tiled/dark/brown_perforated/airless,
/area/template_noop)
"zC" = (
/obj/structure/medical_stand,
/turf/floor/tiled/derelict/red_white_edges/airless,
/area/template_noop)
"Ae" = (
/obj/structure/window/reinforced{
	dir = 8
	},
/turf/floor/tiled/dark/brown_platform/airless,
/area/template_noop)
"Ax" = (
/obj/structure/railing/grey{
	dir = 8
	},
/turf/floor/dirt/airless,
/area/template_noop)
"Bj" = (
/mob/living/simple_animal/hostile/roomba/slayer,
/turf/floor/tiled/cafe/airless,
/area/template_noop)
"BH" = (
/obj/structure/largecrate,
/turf/floor/tiled/derelict/airless,
/area/template_noop)
"BI" = (
/obj/effect/floor_decal/industrial/warning,
/mob/living/simple_animal/hostile/roomba/boomba,
/turf/floor/tiled/derelict/airless,
/area/template_noop)
"Cs" = (
/obj/structure/window/reinforced{
	dir = 4
	},
/obj/machinery/light/floor,
/obj/item/remains/human,
/obj/effect/decal/cleanable/blood,
/obj/machinery/light,
/turf/floor/tiled/dark/brown_platform/airless,
/area/template_noop)
"Dc" = (
/mob/living/simple_animal/hostile/roomba/boomba,
/turf/floor/tiled/derelict/airless,
/area/template_noop)
"Ej" = (
/obj/structure/table/onestar,
/obj/item/phone,
/turf/floor/tiled/dark/brown_perforated/airless,
/area/template_noop)
"ES" = (
/turf/wall/untinted/onestar_reinforced,
/area/template_noop)
"Fb" = (
/obj/machinery/light_construct{
	dir = 1
	},
/turf/floor/tiled/derelict/white_red_edges/airless,
/area/template_noop)
"Fz" = (
/obj/effect/floor_decal/industrial/warning,
/turf/floor/tiled/derelict/airless,
/area/template_noop)
"FA" = (
/obj/structure/window/reinforced{
	dir = 1
	},
/obj/structure/bed/chair/office/dark,
/obj/item/remains/human,
/turf/floor/tiled/dark/brown_platform/airless,
/area/template_noop)
"Gb" = (
/obj/machinery/vending/coffee,
/turf/floor/tiled/derelict/white_small_edges/airless,
/area/template_noop)
"Gt" = (
/obj/machinery/light,
/turf/floor/tiled/derelict/white_small_edges/airless,
/area/template_noop)
"GP" = (
/obj/structure/window/reinforced{
	dir = 8
	},
/obj/structure/window/reinforced{
	dir = 1
	},
/obj/structure/table/onestar,
/obj/item/stamp/denied,
/obj/structure/barricade,
/turf/floor/tiled/dark/brown_perforated/airless,
/area/template_noop)
"GZ" = (
/obj/structure/window/reinforced{
	dir = 4
	},
/obj/structure/table/onestar,
/obj/item/stamp/denied,
/turf/floor/tiled/dark/brown_perforated/airless,
/area/template_noop)
"Hc" = (
/obj/structure/window/reinforced{
	dir = 4
	},
/obj/item/modular_computer/console{
	dir = 8
	},
/turf/floor/tiled/dark/brown_perforated/airless,
/area/template_noop)
"HY" = (
/obj/item/modular_computer/console,
/turf/floor/tiled/dark/brown_platform/airless,
/area/template_noop)
"It" = (
/obj/structure/window/reinforced{
	dir = 8
	},
/obj/structure/table/onestar,
/obj/item/paper_bin,
/obj/item/pen,
/obj/effect/decal/cleanable/blood/drip,
/obj/item/gun/projectile/handmade_pistol,
/obj/spawner/ammo,
/turf/floor/tiled/dark/brown_perforated/airless,
/area/template_noop)
"JA" = (
/obj/structure/window/reinforced{
	dir = 4
	},
/obj/structure/window/reinforced{
	dir = 1
	},
/obj/structure/table/onestar,
/obj/item/device/lighting/toggleable/lamp,
/turf/floor/tiled/dark/brown_perforated/airless,
/area/template_noop)
"Km" = (
/turf/floor/tiled/cafe/airless,
/area/template_noop)
"Kw" = (
/obj/spawner/junk,
/turf/floor/plating/under/airless,
/area/template_noop)
"KW" = (
/turf/floor/tiled/derelict/airless,
/area/template_noop)
"KX" = (
/obj/spawner/junk/low_chance,
/turf/floor/tiled/derelict/white_small_edges/airless,
/area/template_noop)
"La" = (
/obj/structure/window/reinforced{
	dir = 1
	},
/obj/structure/window/reinforced{
	dir = 4
	},
/obj/structure/table/onestar,
/obj/item/paper_bin,
/obj/item/pen,
/turf/floor/tiled/dark/brown_perforated/airless,
/area/template_noop)
"Lz" = (
/obj/structure/railing/grey,
/turf/floor/dirt/airless,
/area/template_noop)
"LE" = (
/obj/structure/closet/emcloset,
/turf/floor/tiled/derelict/white_small_edges/airless,
/area/template_noop)
"LY" = (
/turf/floor/tiled/dark/brown_platform/airless,
/area/template_noop)
"ME" = (
/obj/structure/sign/department/medbay{
	pixel_x = 32
	},
/mob/living/simple_animal/hostile/roomba/slayer,
/turf/floor/tiled/derelict/white_small_edges/airless,
/area/template_noop)
"NH" = (
/turf/floor/tiled/derelict/white_red_edges/airless,
/area/template_noop)
"NQ" = (
/obj/structure/reagent_dispensers/water_cooler,
/turf/floor/tiled/derelict/white_small_edges/airless,
/area/template_noop)
"Oz" = (
/obj/structure/sign/faction/one_star,
/turf/wall/untinted/onestar_reinforced,
/area/template_noop)
"OV" = (
/obj/structure/sign/faction/one_star_old,
/turf/wall/untinted/onestar,
/area/template_noop)
"Pb" = (
/obj/machinery/light{
	dir = 1
	},
/turf/floor/tiled/derelict/red_white_edges/airless,
/area/template_noop)
"Pc" = (
/obj/structure/table/onestar,
/obj/machinery/light/floor,
/obj/item/storage/lunchbox/rainbow,
/turf/floor/tiled/dark/brown_perforated/airless,
/area/template_noop)
"Qe" = (
/obj/structure/sign/derelict2{
	pixel_y = 32
	},
/turf/floor/tiled/derelict/white_small_edges/airless,
/area/template_noop)
"Qn" = (
/obj/structure/bed/chair/custom/onestar{
	dir = 4
	},
/turf/floor/tiled/derelict/red_white_edges/airless,
/area/template_noop)
"QE" = (
/obj/structure/window/reinforced{
	dir = 8
	},
/obj/structure/window/reinforced{
	dir = 6
	},
/obj/structure/table/onestar,
/obj/item/paper_bin,
/turf/floor/tiled/dark/brown_perforated/airless,
/area/template_noop)
"Rf" = (
/obj/machinery/vending,
/turf/floor/tiled/derelict/airless,
/area/template_noop)
"Rn" = (
/obj/structure/window/reinforced{
	dir = 8
	},
/obj/structure/bed/chair/office/dark{
	dir = 4
	},
/obj/machinery/light/floor,
/turf/floor/tiled/dark/brown_platform/airless,
/area/template_noop)
"Ss" = (
/obj/structure/toilet{
	dir = 8
	},
/obj/machinery/light{
	dir = 1
	},
/mob/living/simple_animal/hostile/roomba/boomba,
/turf/floor/tiled/cafe/airless,
/area/template_noop)
"SV" = (
/obj/structure/table/onestar,
/obj/item/device/lighting/toggleable/lamp,
/turf/floor/tiled/dark/brown_perforated/airless,
/area/template_noop)
"UT" = (
/obj/structure/lattice,
/turf/template_noop,
/area/template_noop)
"Vu" = (
/turf/floor/tiled/derelict/white_small_edges/airless,
/area/template_noop)
"VG" = (
/obj/structure/bed/chair/office/dark{
	dir = 4
	},
/obj/item/lipstick/black,
/turf/floor/tiled/dark/brown_platform/airless,
/area/template_noop)
"VK" = (
/obj/structure/window/reinforced{
	dir = 4
	},
/obj/structure/window/reinforced{
	dir = 6
	},
/obj/structure/table/onestar,
/obj/item/paper_bin,
/turf/floor/tiled/dark/brown_perforated/airless,
/area/template_noop)
"Xm" = (
/obj/structure/table/onestar,
/obj/item/pen/reagent/sleepy,
/obj/item/newspaper,
/turf/floor/tiled/dark/brown_perforated/airless,
/area/template_noop)
"XL" = (
/obj/structure/bed/chair/comfy/beige{
	dir = 8
	},
/obj/machinery/light{
	dir = 4
	},
/turf/floor/tiled/derelict/white_small_edges/airless,
/area/template_noop)
"Yy" = (
/obj/structure/bed/padded,
/obj/item/bedsheet/medical,
/obj/spawner/medical,
/obj/machinery/light_construct,
/turf/floor/tiled/derelict/red_white_edges/airless,
/area/template_noop)
"Ze" = (
/obj/machinery/light{
	dir = 8
	},
/turf/floor/tiled/derelict/white_small_edges/airless,
/area/template_noop)
"Zy" = (
/turf/template_noop,
/area/template_noop)

(1,1,1) = {"
Zy
Zy
Zy
Zy
Zy
Zy
Zy
Zy
Zy
Zy
Zy
UT
UT
Zy
Zy
Zy
Zy
Zy
Zy
Zy
Zy
UT
UT
Zy
Zy
"}
(2,1,1) = {"
Zy
Zy
Zy
ag
UT
Kw
UT
Zy
Zy
Zy
UT
ag
ah
UT
Zy
Zy
Zy
Zy
Zy
Zy
Zy
ag
Kw
ah
UT
"}
(3,1,1) = {"
Zy
Zy
UT
ES
ES
ES
ES
ES
ES
ES
ES
ES
ah
ah
Zy
Zy
Zy
Zy
Zy
Zy
ah
ES
ag
ag
UT
"}
(4,1,1) = {"
Zy
Zy
ah
aJ
bv
VG
nF
LY
sD
vL
Pc
ES
Vu
ah
UT
ag
Zy
Zy
UT
ah
ah
ES
aQ
ah
Zy
"}
(5,1,1) = {"
Zy
UT
UT
ES
pa
VK
KW
nR
qw
FA
Xm
ES
Vu
Vu
ah
ES
ES
ES
ES
ES
ag
ag
ah
UT
Zy
"}
(6,1,1) = {"
Zy
ah
ah
bl
KW
KW
Dc
BH
Fz
nC
Ej
ES
Vu
KX
up
ES
pb
bb
bd
ah
ah
UT
Zy
Zy
Zy
"}
(7,1,1) = {"
Zy
ah
Vu
aK
KW
KW
KW
KW
Fz
Ae
Rn
ES
Qe
Vu
Vu
aK
Bj
mJ
Km
ah
UT
UT
Zy
Zy
Zy
"}
(8,1,1) = {"
Zy
ah
Vu
ES
by
KW
KW
KW
KW
La
Hc
ES
Vu
Vu
fa
ES
Km
uQ
Km
ah
ah
ag
Zy
Zy
Zy
"}
(9,1,1) = {"
UT
ah
Kw
ES
bG
QE
KW
KW
KW
GP
It
ES
Vu
Vu
Vu
ES
aK
bN
aK
bN
aK
ES
Zy
Zy
Zy
"}
(10,1,1) = {"
Zy
UT
ah
ES
qp
kF
tl
KW
BI
an
Cs
ES
aA
Vu
Vu
ES
Ss
bN
fy
bN
fy
ES
UT
Zy
Zy
"}
(11,1,1) = {"
Zy
Zy
UT
ES
yJ
xc
tl
KW
Fz
ao
yJ
ES
Vu
Vu
Vu
ES
ES
ES
ES
ES
ES
ES
ah
Zy
Zy
"}
(12,1,1) = {"
Zy
Zy
Zy
ES
zj
co
KW
KW
KW
JA
GZ
ES
KX
Vu
Vu
NQ
Gb
bN
bm
bm
bs
ES
UT
Zy
Zy
"}
(13,1,1) = {"
Zy
Zy
Zy
ES
HY
pS
tl
KW
KW
KW
as
ES
Vu
Vu
Vu
vG
oc
aK
bm
cK
bt
ES
Zy
Zy
Zy
"}
(14,1,1) = {"
Zy
Zy
UT
ES
SV
kb
sB
gK
KW
ju
Rf
ES
Vu
Vu
Vu
XL
kx
bN
Pb
Qn
rb
ES
Zy
Zy
Zy
"}
(15,1,1) = {"
Zy
ag
ag
ES
ES
ES
ES
ES
aK
ES
ES
Oz
Vu
Vu
Vu
bN
bN
bN
xf
ib
bN
ES
UT
Zy
Zy
"}
(16,1,1) = {"
Zy
UT
ah
bq
KX
Vu
Ze
Vu
Vu
fa
Vu
Vu
Vu
Vu
Vu
aN
aR
ku
ku
aT
aR
ah
ah
UT
Zy
"}
(17,1,1) = {"
Zy
ah
ah
Vu
Vu
Vu
Vu
Vu
Vu
Vu
Vu
Vu
Vu
Vu
Vu
bN
bN
bN
bN
bN
OV
ah
ah
Zy
Zy
"}
(18,1,1) = {"
Zy
Zy
ah
ah
Vu
ME
Vu
Vu
Vu
Vu
Vu
KX
Vu
Vu
Vu
nI
aT
ku
ku
nI
aN
ah
ah
Zy
Zy
"}
(19,1,1) = {"
Zy
Zy
UT
ag
aK
bN
bN
Ax
Ax
Ax
au
ax
Vu
Vu
bN
bN
ib
dO
bN
bN
bN
ES
ah
UT
Zy
"}
(20,1,1) = {"
Zy
Zy
ah
bm
cK
zC
bN
bE
bE
bE
bE
ay
Vu
Gt
bN
bm
aU
wg
bN
zc
bu
ES
UT
UT
Zy
"}
(21,1,1) = {"
Zy
Zy
UT
ah
bm
Yy
bN
bE
bE
bE
bE
Lz
fa
oc
aK
bm
cK
bm
bN
lj
NH
ag
Zy
Zy
Zy
"}
(22,1,1) = {"
Zy
Zy
Zy
ah
ah
eD
bN
jG
wF
bE
bE
Lz
Vu
LE
bN
rb
bt
bs
bN
Fb
ah
UT
Zy
Zy
Zy
"}
(23,1,1) = {"
Zy
Zy
Zy
Zy
UT
ES
ES
ES
ES
ES
ES
ES
ES
ES
ES
ES
ES
ES
ES
ah
ah
UT
Zy
Zy
Zy
"}
(24,1,1) = {"
Zy
Zy
Zy
Zy
Zy
Zy
ag
ah
Zy
Zy
Zy
Zy
UT
ah
ES
aQ
UT
Zy
UT
Zy
Zy
Zy
Zy
Zy
Zy
"}
(25,1,1) = {"
Zy
Zy
Zy
Zy
Zy
Zy
UT
UT
Zy
Zy
Zy
Zy
Zy
UT
ag
ah
Zy
Zy
Zy
Zy
Zy
Zy
Zy
Zy
Zy
"}
