//MAP CONVERTED BY dmm2tgm.py THIS HEADER COMMENT PREVENTS RECONVERSION, DO NOT REMOVE
"aa" = (
/turf/template_noop,
/area/template_noop)
"ab" = (
/obj/structure/lattice,
/turf/template_noop,
/area/template_noop)
"ac" = (
/turf/simulated/floor/plating/under,
/area/template_noop)
"ad" = (
/obj/structure/girder,
/turf/simulated/floor/plating/under,
/area/template_noop)
"ae" = (
/turf/simulated/floor/tiled/derelict/white_small_edges,
/area/template_noop)
"af" = (
/turf/simulated/floor/tiled/derelict/white_big_edges,
/area/template_noop)
"ag" = (
/turf/simulated/wall/untinted/onestar_reinforced,
/area/template_noop)
"ah" = (
/obj/spawner/junk,
/obj/structure/sign/derelict2{
	pixel_y = 32
	},
/turf/simulated/floor/tiled/derelict/white_small_edges,
/area/template_noop)
"ai" = (
/obj/spawner/scrap/dense,
/turf/simulated/floor/plating/under,
/area/template_noop)
"aj" = (
/obj/machinery/door/airlock/sandstone{
	name = "OneStar Airlock"
	},
/turf/simulated/floor/tiled/derelict,
/area/template_noop)
"ak" = (
/obj/structure/table/onestar,
/turf/simulated/floor/tiled/derelict/white_small_edges,
/area/template_noop)
"al" = (
/obj/machinery/bodyscanner,
/turf/simulated/floor/tiled/derelict/white_small_edges,
/area/template_noop)
"am" = (
/obj/machinery/body_scanconsole,
/turf/simulated/floor/tiled/derelict/white_small_edges,
/area/template_noop)
"an" = (
/obj/structure/bed/chair/custom/onestar{
	dir = 8
	},
/turf/simulated/floor/tiled/derelict/white_small_edges,
/area/template_noop)
"ao" = (
/turf/simulated/floor/tiled/derelict,
/area/template_noop)
"ap" = (
/obj/structure/salvageable/os/data,
/turf/simulated/floor/tiled/derelict/white_small_edges,
/area/template_noop)
"aq" = (
/obj/structure/bed/chair/custom/onestar/red,
/turf/simulated/floor/tiled/derelict/white_small_edges,
/area/template_noop)
"ar" = (
/obj/structure/salvageable/os/implant_container,
/turf/simulated/floor/tiled/derelict/white_small_edges,
/area/template_noop)
"as" = (
/obj/structure/table/onestar,
/obj/structure/window/basic,
/turf/simulated/floor/tiled/derelict/white_small_edges,
/area/template_noop)
"at" = (
/obj/structure/table/onestar,
/obj/machinery/door/window/southright,
/turf/simulated/floor/tiled/derelict/white_small_edges,
/area/template_noop)
"au" = (
/obj/structure/railing,
/turf/template_noop,
/area/template_noop)
"av" = (
/mob/living/simple_animal/hostile/roomba/gun_ba,
/turf/simulated/floor/tiled/derelict,
/area/template_noop)
"aw" = (
/obj/structure/catwalk,
/turf/template_noop,
/area/template_noop)
"ax" = (
/obj/structure/catwalk,
/obj/machinery/door/airlock/external,
/turf/template_noop,
/area/template_noop)
"ay" = (
/obj/structure/railing{
	dir = 1
	},
/turf/template_noop,
/area/template_noop)
"az" = (
/obj/machinery/light/floor,
/turf/simulated/floor/tiled/derelict/white_small_edges,
/area/template_noop)
"aA" = (
/mob/living/simple_animal/hostile/roomba/slayer,
/turf/simulated/floor/tiled/derelict/white_big_edges,
/area/template_noop)
"aB" = (
/obj/structure/sign/derelict2,
/turf/simulated/wall/untinted/onestar_reinforced,
/area/template_noop)
"aC" = (
/obj/machinery/vending/cola,
/turf/simulated/floor/tiled/derelict,
/area/template_noop)
"aD" = (
/obj/machinery/vending/coffee,
/turf/simulated/floor/tiled/derelict/white_small_edges,
/area/template_noop)
"aE" = (
/obj/machinery/optable,
/turf/simulated/floor/tiled/derelict/white_big_edges,
/area/template_noop)
"aF" = (
/obj/structure/reagent_dispensers/water_cooler,
/turf/simulated/floor/tiled/derelict,
/area/template_noop)
"aG" = (
/turf/simulated/wall/untinted/onestar,
/area/template_noop)
"aH" = (
/mob/living/simple_animal/hostile/roomba/boomba,
/turf/simulated/floor/tiled/derelict/white_big_edges,
/area/template_noop)
"aI" = (
/obj/structure/window/basic,
/turf/simulated/floor/tiled/derelict/white_big_edges,
/area/template_noop)
"aJ" = (
/obj/structure/window/basic,
/obj/structure/bed/chair/custom/onestar/red,
/turf/simulated/floor/tiled/derelict/white_big_edges,
/area/template_noop)
"aK" = (
/obj/structure/closet/onestar/tier1/medical,
/obj/item/reagent_containers/blood/empty,
/turf/simulated/floor/tiled/derelict/white_big_edges,
/area/template_noop)
"aL" = (
/obj/structure/closet/onestar/tier1/medical,
/turf/simulated/floor/tiled/derelict/white_big_edges,
/area/template_noop)
"aM" = (
/obj/structure/sink{
	dir = 8;
	icon_state = "sink";
	pixel_x = -12;
	pixel_y = 2
	},
/turf/simulated/floor/tiled/derelict/white_big_edges,
/area/template_noop)
"aN" = (
/obj/structure/medical_stand,
/turf/simulated/floor/tiled/derelict/white_big_edges,
/area/template_noop)
"aO" = (
/obj/structure/table/onestar,
/obj/spawner/surgery_tool,
/obj/spawner/surgery_tool,
/obj/spawner/surgery_tool,
/obj/spawner/surgery_tool/low_chance,
/obj/item/reagent_containers/blood/OMinus,
/turf/simulated/floor/tiled/derelict/white_big_edges,
/area/template_noop)
"aP" = (
/obj/spawner/junk,
/turf/simulated/floor/tiled/derelict/white_small_edges,
/area/template_noop)
"aQ" = (
/obj/spawner/soda,
/obj/spawner/soda,
/turf/simulated/floor/tiled/derelict,
/area/template_noop)
"aR" = (
/obj/machinery/vending/cigarette,
/turf/simulated/floor/tiled/derelict/white_small_edges,
/area/template_noop)
"aS" = (
/obj/structure/sign/examroom,
/turf/simulated/wall/untinted/onestar,
/area/template_noop)
"aT" = (
/obj/structure/sign/directions/evac{
	dir = 8;
	icon_state = "direction_evac"
	},
/turf/simulated/wall/untinted/onestar,
/area/template_noop)
"aU" = (
/obj/spawner/scrap/sparse,
/turf/simulated/floor/tiled/derelict/white_big_edges,
/area/template_noop)
"aW" = (
/obj/structure/noticeboard,
/turf/simulated/wall/untinted/onestar,
/area/template_noop)
"aX" = (
/obj/spawner/junk,
/turf/simulated/floor/tiled/derelict,
/area/template_noop)
"aY" = (
/obj/spawner/medical/low_chance,
/turf/simulated/floor/tiled/derelict,
/area/template_noop)
"aZ" = (
/obj/spawner/junk,
/turf/simulated/floor/tiled/derelict/white_big_edges,
/area/template_noop)
"ba" = (
/obj/spawner/medical/low_chance,
/obj/spawner/medical/low_chance,
/obj/spawner/medical/low_chance,
/turf/simulated/floor/tiled/derelict/white_big_edges,
/area/template_noop)
"bb" = (
/obj/item/reagent_containers/blood/OMinus,
/obj/spawner/medical/low_chance,
/turf/simulated/floor/tiled/derelict/white_big_edges,
/area/template_noop)
"bc" = (
/obj/spawner/junk,
/turf/simulated/floor/plating/under,
/area/template_noop)
"bd" = (
/obj/spawner/medical/low_chance,
/turf/simulated/floor/plating/under,
/area/template_noop)
"be" = (
/obj/item/reagent_containers/blood/OMinus,
/obj/spawner/medical/low_chance,
/obj/spawner/junk,
/turf/simulated/floor/tiled/derelict/white_big_edges,
/area/template_noop)
"bf" = (
/obj/structure/table/onestar,
/obj/spawner/surgery_tool,
/obj/spawner/surgery_tool,
/obj/spawner/surgery_tool,
/obj/spawner/surgery_tool,
/obj/spawner/surgery_tool/low_chance,
/obj/item/reagent_containers/blood/OMinus,
/obj/spawner/medical,
/turf/simulated/floor/tiled/derelict/white_big_edges,
/area/template_noop)
"bg" = (
/obj/structure/table/onestar,
/obj/item/tool/screwdriver/combi_driver/onestar,
/obj/item/tool/crowbar/onestar,
/obj/spawner/prothesis_one_star,
/obj/spawner/prothesis_one_star,
/obj/spawner/medical,
/turf/simulated/floor/tiled/derelict/white_big_edges,
/area/template_noop)
"bh" = (
/obj/spawner/junk,
/obj/spawner/junk,
/obj/spawner/junk,
/obj/spawner/junk,
/turf/simulated/floor/plating/under,
/area/template_noop)
"bi" = (
/obj/item/bodybag,
/obj/item/reagent_containers/glass/bottle/antitoxin{
	pixel_x = -4;
	pixel_y = 8
	},
/obj/item/reagent_containers/glass/bottle/inaprovaline{
	pixel_x = 4;
	pixel_y = 7
	},
/obj/item/reagent_containers/syringe,
/obj/item/reagent_containers/syringe/spaceacillin,
/obj/item/reagent_containers/syringe/spaceacillin,
/obj/structure/table/onestar,
/obj/spawner/medical,
/turf/simulated/floor/tiled/derelict/white_small_edges,
/area/template_noop)
"bj" = (
/obj/item/roller{
	pixel_y = 8
	},
/obj/item/reagent_containers/blood/OMinus,
/obj/item/reagent_containers/blood/OMinus,
/obj/item/reagent_containers/syringe/spaceacillin,
/obj/structure/table/onestar,
/obj/spawner/medical,
/turf/simulated/floor/tiled/derelict/white_small_edges,
/area/template_noop)
"bk" = (
/obj/spawner/junkfood,
/turf/simulated/floor/tiled/derelict/white_small_edges,
/area/template_noop)
"bl" = (
/obj/spawner/medical/low_chance,
/turf/simulated/floor/tiled/derelict/white_small_edges,
/area/template_noop)
"bm" = (
/obj/spawner/junkfood,
/turf/simulated/floor/plating/under,
/area/template_noop)
"bn" = (
/obj/structure/lattice,
/turf/simulated/floor/plating/under,
/area/template_noop)
"bo" = (
/obj/spawner/junk,
/obj/spawner/junk,
/turf/simulated/floor/plating/under,
/area/template_noop)
"bp" = (
/obj/structure/railing,
/obj/structure/lattice,
/turf/template_noop,
/area/template_noop)
"bq" = (
/obj/spawner/soda,
/turf/simulated/floor/tiled/derelict,
/area/template_noop)
"br" = (
/obj/spawner/junkfood,
/turf/simulated/floor/tiled/derelict,
/area/template_noop)
"bs" = (
/obj/structure/railing{
	dir = 1
	},
/obj/structure/lattice,
/turf/template_noop,
/area/template_noop)
"bK" = (
/obj/spawner/scrap/sparse,
/turf/simulated/floor/plating/under,
/area/template_noop)
"rh" = (
/obj/spawner/junk,
/obj/structure/sign/derelict3{
	pixel_y = 32
	},
/turf/simulated/floor/tiled/derelict,
/area/template_noop)
"uc" = (
/mob/living/simple_animal/hostile/roomba/gun_ba,
/turf/simulated/floor/tiled/derelict/white_small_edges,
/area/template_noop)
"EA" = (
/mob/living/simple_animal/hostile/roomba/slayer,
/turf/simulated/floor/tiled/derelict,
/area/template_noop)
"Lk" = (
/obj/structure/sign/derelict1{
	pixel_y = 32
	},
/turf/simulated/floor/tiled/derelict,
/area/template_noop)

(1,1,1) = {"
aa
aa
aa
aa
aa
aa
aa
aa
aa
aa
aa
aa
aa
aa
aa
aa
aa
aa
aa
aa
aa
ab
ab
aa
aa
"}
(2,1,1) = {"
aa
aa
aa
aa
aa
aa
aa
aa
aa
ab
ab
aa
ab
ab
aa
aa
aa
aa
aa
aa
aa
ab
aa
aa
aa
"}
(3,1,1) = {"
aa
aa
aa
aa
aa
aa
aa
aa
aa
aa
ab
ab
ab
ab
ab
aa
aa
ad
ab
ab
ab
ac
ac
ac
ab
"}
(4,1,1) = {"
aa
ab
ac
ag
ag
ag
ag
ag
ag
ag
ag
ag
ag
ad
ad
bn
ab
ad
au
aw
ay
ad
bK
ac
ab
"}
(5,1,1) = {"
ab
ab
bK
ag
aP
aC
aD
ag
af
aA
aM
aO
ag
bK
ac
ac
ac
ad
bp
aw
bs
ad
ac
ab
aa
"}
(6,1,1) = {"
aa
aa
ac
ag
ao
aQ
aQ
ag
af
aI
af
bf
ag
ac
ac
ac
ac
ad
au
aw
ay
ad
ab
aa
aa
"}
(7,1,1) = {"
aa
aa
ac
aj
ae
aX
ae
aj
af
aJ
af
af
ag
ac
ac
ac
ac
ag
au
aw
ay
ag
ac
ab
ab
"}
(8,1,1) = {"
aa
ab
ac
ag
ae
ao
ae
ag
af
aJ
aN
aE
ag
bh
bh
bo
ai
ag
ag
ax
ag
ag
ad
ad
aa
"}
(9,1,1) = {"
aa
ab
ac
ag
ae
av
ae
ag
ag
ag
ag
ag
ag
ag
ag
ag
ag
aT
ao
ao
ao
ae
bl
ad
aa
"}
(10,1,1) = {"
aa
ab
ac
ag
ae
ao
ae
ag
af
af
aM
bg
ag
bi
aP
ap
ap
aG
Lk
ao
ao
aP
ae
ad
ab
"}
(11,1,1) = {"
aa
ab
ac
aj
ao
ao
ao
aj
af
aI
af
af
ag
bj
ae
ae
aP
aG
rh
ao
ao
ae
az
ad
ab
"}
(12,1,1) = {"
ab
aa
ac
ag
aP
ao
aP
ag
af
aJ
aN
aE
ag
ak
ae
ae
aq
as
ao
ao
EA
ae
ae
ad
aa
"}
(13,1,1) = {"
ab
ab
ac
ag
aP
ao
ae
ag
ag
ag
ag
ag
ag
ae
ae
uc
aq
as
ao
ao
ao
aP
ae
ad
ab
"}
(14,1,1) = {"
aa
ab
ac
ag
ae
aY
aP
ag
aZ
aK
aL
aL
ag
al
ae
ae
ae
at
ao
ao
ao
ae
ac
ad
ab
"}
(15,1,1) = {"
aa
aa
ac
aj
ao
ao
ao
aj
af
aH
af
af
ag
am
ae
aP
ae
aG
aF
ao
ao
ae
bd
ab
aa
"}
(16,1,1) = {"
aa
ab
ac
ag
ae
ao
ae
ag
ba
aL
aL
aL
ag
an
ae
ae
ar
aW
bq
ao
ao
ae
ad
ab
aa
"}
(17,1,1) = {"
aa
ac
ac
ag
ah
ao
aP
ag
ag
ag
ag
ag
ag
aG
aS
aj
aG
aG
aC
br
ao
bl
ac
ab
aa
"}
(18,1,1) = {"
ab
ab
ac
ac
ao
aY
ao
ao
ao
ao
ao
ao
ao
ao
EA
ao
ao
ao
ao
ao
ao
ae
ad
ab
aa
"}
(19,1,1) = {"
ab
ac
ac
ac
ao
ao
ao
ao
ao
ao
ao
ao
ao
aY
ao
ao
ao
aX
ao
ao
aY
ae
ad
aa
aa
"}
(20,1,1) = {"
ab
ac
ad
ag
ac
ac
ac
ag
ag
ag
ag
ag
aB
bk
bl
ae
ae
ae
ae
ae
ae
ae
ad
ab
ab
"}
(21,1,1) = {"
ab
ac
ac
ag
ac
ac
ac
ag
bb
be
af
aU
ag
bk
bk
ae
ae
ae
ae
ae
ae
ae
ad
aa
ab
"}
(22,1,1) = {"
ab
ab
ac
ag
ac
ac
ac
ag
bc
bc
ac
ac
ag
aR
bk
ae
ae
ae
ae
bl
ae
ae
ad
aa
aa
"}
(23,1,1) = {"
ab
ab
bK
ag
ai
ab
ac
ag
ac
ab
ab
bc
ag
ag
bK
ad
ag
ad
ag
ag
ag
ag
ag
ab
ab
"}
(24,1,1) = {"
ab
ab
ad
ag
ad
ab
ab
ac
bd
ab
ac
ac
ab
ad
bm
aa
ab
ab
ab
aa
aa
aa
ab
aa
aa
"}
(25,1,1) = {"
aa
ab
ac
ab
ab
aa
ab
ab
aa
aa
aa
aa
aa
aa
aa
aa
aa
aa
aa
aa
aa
aa
ab
aa
aa
"}
