//MAP CONVERTED BY dmm2tgm.py THIS HEADER COMMENT PREVENTS RECONVERSION, DO NOT REMOVE
"am" = (
/turf/simulated/floor/wood,
/area/template_noop)
"an" = (
/obj/structure/railing/grey{
	dir = 4
	},
/obj/machinery/light{
	dir = 8
	},
/turf/simulated/floor/plating/under,
/area/template_noop)
"ao" = (
/obj/structure/catwalk,
/turf/simulated/floor/plating/under,
/area/template_noop)
"aq" = (
/obj/structure/window/reinforced{
	dir = 1
	},
/obj/effect/floor_decal/industrial/warning,
/turf/simulated/floor/tiled/dark/brown_perforated,
/area/template_noop)
"as" = (
/obj/machinery/computer/prisoner{
	dir = 4
	},
/turf/simulated/floor/tiled/dark/brown_perforated,
/area/template_noop)
"aw" = (
/obj/structure/low_wall/onestar,
/obj/effect/window_lwall_spawn/smartspawn/onestar,
/turf/simulated/floor/tiled/dark/brown_perforated,
/area/template_noop)
"ay" = (
/obj/structure/railing/grey,
/turf/simulated/floor/dirt,
/area/template_noop)
"aA" = (
/obj/effect/floor_decal/industrial/warning/corner{
	dir = 4
	},
/turf/simulated/floor/tiled/derelict,
/area/template_noop)
"aF" = (
/obj/structure/railing/grey{
	dir = 4
	},
/obj/structure/railing/grey{
	dir = 1
	},
/turf/simulated/floor/plating/under,
/area/template_noop)
"aH" = (
/obj/machinery/door/window/northright,
/obj/effect/floor_decal/industrial/warning,
/turf/simulated/floor/tiled/dark/brown_perforated,
/area/template_noop)
"aI" = (
/obj/machinery/door/window/northleft,
/obj/effect/floor_decal/industrial/warning,
/turf/simulated/floor/tiled/dark/brown_perforated,
/area/template_noop)
"aJ" = (
/obj/spawner/lowkeyrandom,
/turf/simulated/floor/tiled/derelict/red_white_edges,
/area/template_noop)
"aN" = (
/obj/spawner/junk/low_chance,
/turf/simulated/floor/tiled/dark/brown_platform,
/area/template_noop)
"aY" = (
/obj/machinery/door/window/northright{
	dir = 2
	},
/obj/effect/floor_decal/industrial/warning{
	dir = 1
	},
/turf/simulated/floor/tiled/dark/brown_perforated,
/area/template_noop)
"bc" = (
/obj/structure/bed,
/turf/simulated/floor/tiled/dark/brown_platform,
/area/template_noop)
"bh" = (
/obj/structure/window/reinforced,
/obj/effect/floor_decal/industrial/warning{
	dir = 1
	},
/turf/simulated/floor/tiled/dark/brown_perforated,
/area/template_noop)
"bi" = (
/turf/template_noop,
/area/template_noop)
"bj" = (
/turf/simulated/floor/tiled/derelict/white_big_edges,
/area/template_noop)
"bm" = (
/obj/machinery/light_construct{
	dir = 1
	},
/turf/simulated/floor/tiled/derelict,
/area/template_noop)
"bq" = (
/obj/spawner/medical,
/obj/machinery/light{
	dir = 4
	},
/turf/simulated/floor/tiled/derelict/red_white_edges,
/area/template_noop)
"bu" = (
/turf/simulated/floor/tiled/derelict,
/area/template_noop)
"by" = (
/obj/spawner/scrap/sparse,
/turf/simulated/floor/tiled/derelict/red_white_edges,
/area/template_noop)
"bA" = (
/obj/effect/floor_decal/industrial/warning{
	dir = 4
	},
/turf/simulated/floor/tiled/derelict,
/area/template_noop)
"bB" = (
/obj/structure/sign/faction/one_star_old,
/turf/simulated/wall/untinted/onestar_reinforced,
/area/template_noop)
"bE" = (
/turf/simulated/floor/dirt,
/area/template_noop)
"bL" = (
/obj/structure/closet/emcloset,
/turf/simulated/floor/tiled/derelict/white_small_edges,
/area/template_noop)
"bN" = (
/obj/spawner/scrap/sparse,
/turf/simulated/floor/tiled/derelict/white_big_edges,
/area/template_noop)
"cV" = (
/obj/machinery/light{
	dir = 1
	},
/turf/simulated/floor/tiled/derelict,
/area/template_noop)
"ee" = (
/obj/structure/bed/chair/custom/onestar{
	dir = 4
	},
/turf/simulated/floor/dirt,
/area/template_noop)
"fv" = (
/obj/structure/sign/derelict3{
	pixel_y = 32
	},
/turf/simulated/floor/tiled/derelict,
/area/template_noop)
"fH" = (
/obj/structure/railing/grey,
/obj/structure/railing/grey{
	dir = 4
	},
/turf/simulated/floor/plating/under,
/area/template_noop)
"gY" = (
/obj/spawner/scrap/dense,
/turf/simulated/floor/tiled/derelict/white_big_edges,
/area/template_noop)
"hO" = (
/obj/structure/largecrate,
/turf/simulated/floor/tiled/derelict/red_white_edges,
/area/template_noop)
"hU" = (
/obj/effect/floor_decal/industrial/warning{
	dir = 1
	},
/turf/simulated/floor/tiled/derelict,
/area/template_noop)
"ic" = (
/mob/living/simple_animal/hostile/roomba/gun_ba,
/turf/simulated/floor/tiled/derelict/white_big_edges,
/area/template_noop)
"if" = (
/obj/structure/sign/derelict1{
	pixel_x = 32
	},
/turf/simulated/floor/tiled/derelict,
/area/template_noop)
"jd" = (
/obj/spawner/junk,
/turf/simulated/floor/tiled/derelict/red_white_edges,
/area/template_noop)
"jj" = (
/obj/spawner/junkfood/rotten,
/turf/simulated/floor/tiled/derelict/white_small_edges,
/area/template_noop)
"jv" = (
/obj/structure/railing,
/turf/template_noop,
/area/template_noop)
"kH" = (
/obj/effect/floor_decal/industrial/warning/corner,
/turf/simulated/floor/tiled/derelict,
/area/template_noop)
"lU" = (
/obj/effect/window_lwall_spawn/smartspawn/onestar,
/turf/simulated/floor/tiled/dark/brown_perforated,
/area/template_noop)
"pA" = (
/mob/living/simple_animal/hostile/roomba/slayer,
/turf/simulated/floor/tiled/derelict/red_white_edges,
/area/template_noop)
"pI" = (
/obj/effect/floor_decal/industrial/warning,
/turf/simulated/floor/tiled/derelict,
/area/template_noop)
"rd" = (
/obj/structure/catwalk,
/turf/simulated/floor/tiled/derelict,
/area/template_noop)
"sf" = (
/obj/structure/sign/faction/one_star,
/turf/simulated/wall/untinted/onestar_reinforced,
/area/template_noop)
"ss" = (
/obj/spawner/material/building/low_chance,
/turf/simulated/floor/tiled/derelict/red_white_edges,
/area/template_noop)
"sF" = (
/obj/spawner/junkfood/rotten,
/turf/simulated/floor/dirt,
/area/template_noop)
"ue" = (
/obj/structure/closet/onestar/tier1,
/turf/simulated/floor/tiled/derelict/red_white_edges,
/area/template_noop)
"um" = (
/obj/structure/sign/derelict2{
	pixel_y = -32
	},
/mob/living/simple_animal/hostile/roomba/slayer,
/turf/simulated/floor/tiled/derelict,
/area/template_noop)
"uK" = (
/obj/machinery/light,
/turf/simulated/floor/tiled/derelict,
/area/template_noop)
"vJ" = (
/mob/living/simple_animal/hostile/roomba/boomba,
/turf/simulated/floor/tiled/derelict,
/area/template_noop)
"wX" = (
/obj/structure/railing/grey{
	dir = 1
	},
/turf/simulated/floor/dirt,
/area/template_noop)
"xb" = (
/obj/structure/table/onestar,
/obj/item/reagent_containers/food/drinks/drinkingglass{
	pixel_x = -5;
	pixel_y = 2
	},
/obj/item/reagent_containers/food/drinks/drinkingglass{
	pixel_x = 5;
	pixel_y = 2
	},
/turf/simulated/floor/dirt,
/area/template_noop)
"yr" = (
/obj/machinery/light_construct{
	dir = 1
	},
/mob/living/simple_animal/hostile/roomba/slayer,
/turf/simulated/floor/tiled/derelict,
/area/template_noop)
"zo" = (
/obj/structure/table/onestar,
/obj/item/deck/cards,
/turf/simulated/floor/dirt,
/area/template_noop)
"zE" = (
/turf/simulated/floor/plating/under,
/area/template_noop)
"zJ" = (
/obj/structure/table/onestar,
/obj/machinery/chemical_dispenser/beer,
/turf/simulated/floor/dirt,
/area/template_noop)
"zM" = (
/obj/structure/table/onestar,
/obj/machinery/chemical_dispenser/soda,
/turf/simulated/floor/dirt,
/area/template_noop)
"Bv" = (
/obj/structure/railing/grey{
	dir = 4
	},
/obj/structure/railing/grey,
/turf/simulated/floor/plating/under,
/area/template_noop)
"CY" = (
/obj/structure/bed/chair/custom/onestar{
	dir = 8
	},
/turf/simulated/floor/dirt,
/area/template_noop)
"Di" = (
/obj/machinery/door/airlock/sandstone{
	name = "OneStar Airlock"
	},
/turf/simulated/floor/tiled/derelict,
/area/template_noop)
"Dm" = (
/obj/structure/railing/grey{
	dir = 1
	},
/obj/structure/railing/grey{
	dir = 4
	},
/turf/simulated/floor/plating/under,
/area/template_noop)
"DP" = (
/obj/item/beach_ball/holoball,
/turf/simulated/floor/dirt,
/area/template_noop)
"DU" = (
/obj/structure/bed/chair/custom/onestar/red,
/turf/simulated/floor/tiled/dark/brown_platform,
/area/template_noop)
"DW" = (
/turf/simulated/floor/tiled/dark/brown_platform,
/area/template_noop)
"EL" = (
/obj/spawner/lowkeyrandom,
/turf/simulated/floor/tiled/derelict/white_big_edges,
/area/template_noop)
"ES" = (
/obj/structure/bed/chair/custom/onestar/red{
	dir = 1
	},
/turf/simulated/floor/tiled/dark/brown_platform,
/area/template_noop)
"Gu" = (
/obj/machinery/light_construct{
	dir = 8
	},
/turf/simulated/floor/tiled/derelict/white_big_edges,
/area/template_noop)
"Hn" = (
/obj/structure/lattice,
/turf/template_noop,
/area/template_noop)
"HN" = (
/obj/structure/table/onestar,
/obj/spawner/lowkeyrandom,
/turf/simulated/floor/tiled/dark/brown_perforated,
/area/template_noop)
"Jl" = (
/obj/structure/railing{
	dir = 1
	},
/turf/template_noop,
/area/template_noop)
"Jx" = (
/obj/spawner/junkfood/rotten,
/turf/simulated/floor/wood,
/area/template_noop)
"Kz" = (
/obj/spawner/soda,
/turf/simulated/floor/wood,
/area/template_noop)
"Lj" = (
/obj/machinery/door/window/northleft{
	dir = 2
	},
/obj/effect/floor_decal/industrial/warning{
	dir = 1
	},
/turf/simulated/floor/tiled/dark/brown_perforated,
/area/template_noop)
"Lk" = (
/mob/living/simple_animal/hostile/roomba/slayer,
/turf/simulated/floor/tiled/derelict,
/area/template_noop)
"LL" = (
/obj/structure/railing/grey{
	dir = 4
	},
/turf/simulated/floor/tiled/dark/techfloor,
/area/template_noop)
"Mb" = (
/obj/spawner/scrap/sparse,
/turf/simulated/floor/plating/under,
/area/template_noop)
"Mm" = (
/obj/machinery/light_construct{
	dir = 8
	},
/mob/living/simple_animal/hostile/roomba/gun_ba,
/turf/simulated/floor/tiled/derelict/white_big_edges,
/area/template_noop)
"Mq" = (
/obj/structure/girder,
/turf/simulated/floor/plating/under,
/area/template_noop)
"Nd" = (
/obj/spawner/material/building,
/turf/simulated/floor/tiled/derelict/red_white_edges,
/area/template_noop)
"Ny" = (
/mob/living/simple_animal/hostile/roomba/gun_ba,
/turf/simulated/floor/tiled/dark/brown_platform,
/area/template_noop)
"NG" = (
/turf/simulated/floor/tiled/derelict/white_small_edges,
/area/template_noop)
"NK" = (
/obj/machinery/light/floor,
/turf/simulated/floor/tiled/derelict/white_small_edges,
/area/template_noop)
"OP" = (
/obj/spawner/scrap/dense,
/turf/simulated/floor/tiled/derelict/red_white_edges,
/area/template_noop)
"So" = (
/obj/structure/toilet{
	dir = 8
	},
/obj/machinery/light_construct{
	dir = 1
	},
/turf/simulated/floor/tiled/derelict/white_big_edges,
/area/template_noop)
"SI" = (
/turf/simulated/floor/tiled/derelict/red_white_edges,
/area/template_noop)
"TW" = (
/obj/machinery/vending/coffee,
/turf/simulated/floor/tiled/derelict/white_small_edges,
/area/template_noop)
"Ul" = (
/obj/structure/catwalk,
/turf/template_noop,
/area/template_noop)
"Wo" = (
/turf/simulated/wall/untinted/onestar_reinforced,
/area/template_noop)
"WA" = (
/turf/simulated/floor/tiled/dark/brown_perforated,
/area/template_noop)
"Yp" = (
/obj/structure/catwalk,
/obj/machinery/door/airlock/external,
/turf/template_noop,
/area/template_noop)
"YT" = (
/obj/machinery/light_construct{
	dir = 4
	},
/turf/simulated/floor/tiled/derelict/red_white_edges,
/area/template_noop)
"YW" = (
/obj/structure/table/onestar,
/obj/spawner/gun/shotgun,
/turf/simulated/floor/tiled/dark/brown_perforated,
/area/template_noop)
"YZ" = (
/obj/machinery/light{
	dir = 4
	},
/obj/structure/closet/onestar/tier2,
/turf/simulated/floor/tiled/dark/brown_perforated,
/area/template_noop)
"Zh" = (
/mob/living/simple_animal/hostile/roomba/slayer,
/turf/simulated/floor/plating/under,
/area/template_noop)
"Zt" = (
/obj/machinery/light{
	dir = 8
	},
/turf/simulated/floor/dirt,
/area/template_noop)

(1,1,1) = {"
bi
bi
bi
bi
bi
bi
bi
bi
bi
bi
bi
bi
bi
bi
bi
bi
bi
bi
bi
bi
bi
bi
bi
bi
bi
"}
(2,1,1) = {"
bi
Hn
zE
bi
bi
bi
bi
bi
bi
bi
bi
bi
bi
bi
bi
bi
bi
bi
bi
bi
bi
bi
bi
bi
bi
"}
(3,1,1) = {"
bi
zE
Mq
Hn
bi
bi
bi
Hn
Wo
lU
Wo
jv
Ul
Jl
Wo
lU
Wo
bi
bi
bi
bi
bi
Mq
bi
bi
"}
(4,1,1) = {"
bi
zE
Mq
Wo
Wo
Wo
Wo
Wo
Wo
zE
Wo
Wo
Yp
Wo
Wo
zE
Wo
Wo
bi
bi
Mq
Mq
Wo
zE
bi
"}
(5,1,1) = {"
bi
Hn
Mq
ss
Nd
Nd
hO
hO
Wo
LL
Bv
bu
bu
bu
aF
LL
Wo
SI
zE
bi
bi
zE
Mq
Hn
bi
"}
(6,1,1) = {"
bi
bi
Wo
SI
SI
SI
pA
SI
Wo
NG
NG
bu
bu
vJ
NG
NG
Wo
SI
zE
zE
bi
Hn
Hn
Hn
bi
"}
(7,1,1) = {"
bi
bi
Wo
aJ
SI
SI
SI
SI
Di
NK
NG
bu
bu
bu
NG
NK
Wo
hO
SI
Zh
zE
zE
Hn
zE
bi
"}
(8,1,1) = {"
bi
Hn
Wo
ue
SI
bq
jd
SI
Wo
TW
jj
bu
bu
if
NG
bL
Wo
OP
SI
YT
SI
by
Wo
zE
bi
"}
(9,1,1) = {"
Hn
Mq
Wo
Wo
Wo
Wo
Wo
Wo
Wo
Wo
Wo
aw
Di
Wo
Wo
Wo
Wo
Wo
Wo
Wo
Wo
Wo
Wo
Mq
bi
"}
(10,1,1) = {"
bi
zE
Wo
bc
bh
bu
kH
bA
Dm
an
fH
bA
aA
bu
aq
bc
Wo
bc
bh
bu
kH
bA
Dm
Hn
bi
"}
(11,1,1) = {"
bi
bi
Wo
aN
aY
bu
pI
rd
ao
ao
ao
rd
hU
bu
aH
aN
Wo
aN
aY
bu
pI
rd
ao
Hn
bi
"}
(12,1,1) = {"
bi
bi
Wo
Wo
Wo
cV
Lk
sf
Wo
Di
Wo
sf
bu
uK
Wo
Wo
Wo
Wo
Wo
bm
Lk
bB
Mq
bi
bi
"}
(13,1,1) = {"
bi
bi
Wo
bc
bh
bu
bu
Wo
as
WA
as
Wo
bu
bu
aq
bc
Wo
bc
bh
bu
bu
Mq
zE
bi
bi
"}
(14,1,1) = {"
bi
bi
Wo
aN
aY
bu
bu
lU
DW
DW
DW
lU
bu
bu
aH
aN
Wo
aN
aY
bu
bu
zE
zE
zE
bi
"}
(15,1,1) = {"
bi
Hn
Wo
Wo
Wo
fv
bu
lU
ES
Ny
DU
lU
bu
um
Wo
Wo
Wo
Wo
Wo
bu
zE
zE
Hn
Hn
bi
"}
(16,1,1) = {"
bi
bi
Wo
aN
Lj
bu
bu
lU
DW
DW
DW
lU
bu
bu
aI
aN
Wo
aN
Lj
bu
bu
zE
zE
Hn
bi
"}
(17,1,1) = {"
bi
bi
Wo
bc
bh
bu
bu
Wo
HN
YZ
YW
Wo
bu
bu
aq
bc
Wo
bc
bh
bu
bu
Wo
zE
Hn
bi
"}
(18,1,1) = {"
bi
bi
Wo
Wo
Wo
cV
bu
sf
lU
Wo
lU
sf
bu
uK
Wo
Wo
Wo
Wo
Wo
yr
bu
bB
zE
bi
bi
"}
(19,1,1) = {"
bi
Hn
Wo
aN
Lj
Lk
bu
am
am
Zt
bE
ay
bu
bu
aI
aN
Wo
aN
Lj
bu
bu
zE
zE
Hn
bi
"}
(20,1,1) = {"
bi
zE
Wo
bc
bh
bu
bu
wX
am
bE
DP
ay
bu
bu
aq
bc
Wo
bc
bh
bu
bu
wX
zE
zE
bi
"}
(21,1,1) = {"
bi
Mq
Wo
Wo
Wo
Wo
Wo
xb
am
bE
bE
ee
Wo
Di
Wo
Wo
Wo
Wo
Wo
Wo
Wo
bE
zE
zE
bi
"}
(22,1,1) = {"
bi
zE
zE
Gu
ic
gY
Wo
zJ
Jx
bE
bE
zo
Wo
EL
Wo
Mb
zE
Mm
bN
gY
Wo
bE
zE
Hn
Hn
"}
(23,1,1) = {"
bi
Hn
zE
zE
bj
bj
Wo
zM
Kz
bE
bE
CY
Wo
So
Wo
Hn
zE
zE
bj
bj
Wo
sF
zE
zE
bi
"}
(24,1,1) = {"
bi
bi
Hn
zE
zE
zE
Wo
Wo
Wo
Wo
Wo
Wo
Wo
Wo
Mq
Hn
Hn
Hn
zE
zE
Wo
Wo
Mq
Hn
bi
"}
(25,1,1) = {"
bi
bi
bi
bi
bi
Hn
Hn
bi
bi
bi
bi
bi
bi
bi
bi
bi
bi
bi
bi
bi
bi
bi
bi
bi
bi
"}
