//MAP CONVERTED BY dmm2tgm.py THIS HEADER COMMENT PREVENTS RECONVERSION, DO NOT REMOVE
"b" = (
/turf/wall/iron,
/area/template_noop)
"c" = (
/obj/machinery/door/unpowered/simple/uranium,
/turf/template_noop,
/area/template_noop)
"d" = (
/turf/wall,
/area/template_noop)
"e" = (
/obj/structure/bed/chair/wood,
/obj/effect/decal/cleanable/cobweb,
/turf/floor/carpet,
/area/template_noop)
"f" = (
/turf/floor/carpet,
/area/template_noop)
"g" = (
/obj/item/trash/candle,
/turf/floor/carpet,
/area/template_noop)
"h" = (
/turf/wall/low/with_glass/smart,
/area/template_noop)
"i" = (
/obj/machinery/artifact,
/turf/floor/reinforced,
/area/template_noop)
"q" = (
/obj/structure/bed/chair/wood,
/obj/spawner/credits/low_chance,
/turf/floor/carpet,
/area/template_noop)
"E" = (
/mob/living/simple_animal/hostile/roomba/boomba,
/turf/floor/carpet,
/area/template_noop)
"I" = (
/obj/structure/bed/chair/wood,
/turf/floor/carpet,
/area/template_noop)
"R" = (
/obj/structure/bed/chair/wood,
/obj/spawner/credits/c1000,
/turf/floor/carpet,
/area/template_noop)

(1,1,1) = {"
d
b
b
d
b
b
d
"}
(2,1,1) = {"
b
e
R
f
g
g
b
"}
(3,1,1) = {"
b
I
I
f
h
h
b
"}
(4,1,1) = {"
c
f
f
E
h
i
d
"}
(5,1,1) = {"
b
q
I
f
h
h
b
"}
(6,1,1) = {"
b
I
q
f
g
g
b
"}
(7,1,1) = {"
d
b
b
d
b
b
d
"}
