"a" = (/turf/simulated/wall,/area/crawler)
"b" = (/obj/crawler/crawler_wallbreaker,/turf/simulated/wall,/area/crawler)
"c" = (/turf/simulated/floor/tiled/dark/gray_perforated,/area/crawler)
"d" = (/obj/random/mob/roaches/low_chance,/turf/simulated/floor/tiled/dark/gray_perforated,/area/crawler)
"e" = (/obj/random/junkfood/rotten,/turf/simulated/floor/tiled/dark/gray_perforated,/area/crawler)
"f" = (/obj/crawler/crawler_wallbreaker/vertical,/turf/simulated/wall,/area/crawler)
"g" = (/obj/random/knife,/turf/simulated/floor/tiled/dark/gray_perforated,/area/crawler)
"h" = (/obj/random/material_resources/low_chance,/turf/simulated/floor/tiled/dark/gray_perforated,/area/crawler)
"i" = (/obj/machinery/light/floor,/turf/simulated/floor/tiled/dark/gray_perforated,/area/crawler)
"j" = (/obj/structure/closet/onestar/tier3,/turf/simulated/floor/tiled/dark/gray_perforated,/area/crawler)

(1,1,1) = {"
aaaaabbbaaaaa
accccccccccca
acdcceccjcdcf
fcccccdcccccf
fccgccccccdcf
fcdccchcdcccf
accdcccccdccf
accciccciccca
aaaabbbbbaaaa
"}
