"a" = (/turf/simulated/wall,/area/crawler)
"b" = (/obj/crawler/crawler_wallbreaker,/turf/simulated/wall,/area/crawler)
"c" = (/turf/simulated/floor/tiled/dark/gray_perforated,/area/crawler)
"d" = (/obj/crawler/crawler_wallbreaker/vertical,/turf/simulated/wall,/area/crawler)
"e" = (/obj/random/mob/roaches,/turf/simulated/floor/tiled/dark/gray_perforated,/area/crawler)
"f" = (/obj/random/action_figure,/turf/simulated/floor/tiled/dark/gray_perforated,/area/crawler)
"g" = (/obj/machinery/light/floor,/turf/simulated/floor/tiled/dark/gray_perforated,/area/crawler)
"h" = (/obj/random/gun_energy_cheap,/turf/simulated/floor/tiled/dark/gray_perforated,/area/crawler)
"i" = (/obj/random/medical_lowcost,/turf/simulated/floor/tiled/dark/gray_perforated,/area/crawler)

(1,1,1) = {"
aaaaabbbaaaaa
accccccccccca
acccccccccccd
dcceccecceccd
dcfcccgcccfcd
dcccchicccccd
acccecccecccd
accccccccccca
aaaabbbbbaaaa
"}
