"a" = (/turf/simulated/wall,/area/crawler)
"b" = (/obj/crawler/crawler_wallbreaker,/turf/simulated/wall,/area/crawler)
"c" = (/turf/simulated/floor/tiled/dark/gray_perforated,/area/crawler)
"d" = (/obj/random/action_figure,/turf/simulated/floor/tiled/dark/gray_perforated,/area/crawler)
"e" = (/obj/crawler/crawler_wallbreaker/vertical,/turf/simulated/wall,/area/crawler)
"f" = (/obj/machinery/light/floor,/turf/simulated/floor/tiled/dark/gray_perforated,/area/crawler)

(1,1,1) = {"
aaaaabbbaaaaa
acdccccdcdcca
acdccccdcdcce
ecdccccdcdcce
ecccccfccccce
ecdcdccdcccce
acdccccdcccce
acdcdccdcddda
aaaabbbbbaaaa
"}
