//MAP CONVERTED BY dmm2tgm.py THIS HEADER COMMENT PREVENTS RECONVERSION, DO NOT REMOVE
"a" = (
/turf/simulated/wall/untinted/onestar_reinforced,
/area/crawler)
"b" = (
/turf/unsimulated/mineral,
/area/crawler)
"c" = (
/turf/simulated/floor/tiled/derelict/red_white_edges,
/area/crawler)
"d" = (
/obj/structure/closet/onestar/tier1,
/turf/simulated/floor/tiled/derelict/red_white_edges,
/area/crawler)
"e" = (
/obj/crawler/crawler_wallbreaker/vertical,
/turf/simulated/wall/untinted/onestar_reinforced,
/area/crawler)
"f" = (
/obj/structure/closet/onestar/tier1/mineral,
/turf/simulated/floor/tiled/derelict/red_white_edges,
/area/crawler)
"g" = (
/obj/machinery/light/small,
/turf/simulated/floor/tiled/derelict/red_white_edges,
/area/crawler)
"h" = (
/obj/crawler/crawler_wallbreaker,
/turf/simulated/wall/untinted/onestar_reinforced,
/area/crawler)

(1,1,1) = {"
a
a
a
e
e
e
a
a
a
"}
(2,1,1) = {"
a
c
c
c
c
c
c
g
a
"}
(3,1,1) = {"
a
c
c
c
c
c
f
c
a
"}
(4,1,1) = {"
a
c
d
c
c
c
c
c
a
"}
(5,1,1) = {"
a
b
c
b
c
c
c
c
h
"}
(6,1,1) = {"
b
b
b
b
b
c
c
c
h
"}
(7,1,1) = {"
b
b
c
c
c
c
c
c
h
"}
(8,1,1) = {"
b
b
b
c
c
c
c
c
h
"}
(9,1,1) = {"
a
b
c
c
c
c
c
c
h
"}
(10,1,1) = {"
a
c
c
c
c
c
c
c
a
"}
(11,1,1) = {"
a
c
c
c
c
c
c
c
a
"}
(12,1,1) = {"
a
c
c
c
c
c
c
c
a
"}
(13,1,1) = {"
a
a
e
e
e
e
e
a
a
"}
