"a" = (/turf/simulated/wall,/area/crawler)
"b" = (/turf/unsimulated/mineral,/area/crawler)
"c" = (/turf/simulated/floor/tiled/dark/gray_perforated,/area/crawler)
"d" = (/obj/structure/closet/onestar/tier1,/turf/simulated/floor/tiled/dark/gray_perforated,/area/crawler)
"e" = (/obj/crawler/crawler_wallbreaker/vertical,/turf/simulated/wall,/area/crawler)
"f" = (/obj/structure/closet/onestar/tier1/mineral,/turf/simulated/floor/tiled/dark/gray_perforated,/area/crawler)
"g" = (/obj/machinery/light/small,/turf/simulated/floor/tiled/dark/gray_perforated,/area/crawler)
"h" = (/obj/crawler/crawler_wallbreaker,/turf/simulated/wall,/area/crawler)

(1,1,1) = {"
aaaaabbbaaaaa
acccbbbbbccca
accdcbcbcccce
ecccbbcccccce
eccccbcccccce
eccccccccccce
acfccccccccce
agcccccccccca
aaaahhhhhaaaa
"}
