//MAP CONVERTED BY dmm2tgm.py THIS HEADER COMMENT PREVENTS RECONVERSION, DO NOT REMOVE
"a" = (
/turf/simulated/wall/untinted/onestar_reinforced,
/area/crawler)
"b" = (
/obj/crawler/crawler_wallbreaker,
/turf/simulated/wall/untinted/onestar_reinforced,
/area/crawler)
"c" = (
/obj/structure/grille,
/turf/simulated/floor/plating/under,
/area/crawler)
"d" = (
/obj/machinery/porta_turret/stationary,
/turf/simulated/floor/plating/under,
/area/crawler)
"e" = (
/obj/structure/railing/grey,
/turf/simulated/floor/plating/under,
/area/crawler)
"f" = (
/obj/crawler/crawler_wallbreaker/vertical,
/turf/simulated/wall/untinted/onestar_reinforced,
/area/crawler)
"g" = (
/obj/random/mob/roomba,
/obj/random/contraband,
/turf/simulated/floor/tiled/dark/brown_perforated,
/area/crawler)
"h" = (
/obj/effect/floor_decal/industrial/danger{
	dir = 4
	},
/turf/simulated/floor/tiled/dark/cargo,
/area/crawler)
"i" = (
/obj/structure/catwalk,
/turf/simulated/floor/plating/under,
/area/crawler)
"j" = (
/obj/effect/floor_decal/industrial/danger{
	dir = 8
	},
/obj/machinery/light/built{
	dir = 4
	},
/turf/simulated/floor/tiled/dark/brown_platform,
/area/crawler)
"k" = (
/obj/random/mob/roomba,
/obj/random/firstaid,
/turf/simulated/floor/tiled/dark/brown_perforated,
/area/crawler)
"l" = (
/obj/effect/floor_decal/industrial/danger{
	dir = 8
	},
/turf/simulated/floor/tiled/dark/brown_platform,
/area/crawler)
"m" = (
/turf/simulated/floor/tiled/dark/cargo,
/area/crawler)
"n" = (
/obj/random/mob/roomba,
/obj/random/contraband,
/turf/simulated/floor/tiled/dark/brown_platform,
/area/crawler)
"o" = (
/obj/structure/table/onestar,
/obj/random/gun_energy_cheap,
/obj/random/gun_energy_cheap,
/obj/random/gun_shotgun,
/turf/simulated/floor/tiled/dark/brown_perforated,
/area/crawler)
"p" = (
/obj/structure/table/onestar,
/obj/random/gun_energy_cheap,
/obj/random/gun_shotgun,
/obj/random/contraband,
/turf/simulated/floor/tiled/dark/brown_perforated,
/area/crawler)
"q" = (
/obj/structure/table/rack,
/obj/random/gun_normal,
/obj/random/gun_normal,
/obj/random/gun_normal/low_chance,
/obj/random/gun_shotgun,
/turf/simulated/floor/tiled/dark/brown_perforated,
/area/crawler)
"s" = (
/obj/structure/railing/grey{
	dir = 1
	},
/turf/simulated/floor/plating/under,
/area/crawler)

(1,1,1) = {"
a
a
a
f
f
f
a
a
a
"}
(2,1,1) = {"
a
c
a
h
h
h
a
c
a
"}
(3,1,1) = {"
a
c
e
i
i
i
s
c
a
"}
(4,1,1) = {"
a
d
e
i
i
i
s
d
a
"}
(5,1,1) = {"
a
c
e
i
i
i
s
c
b
"}
(6,1,1) = {"
b
c
a
j
l
j
a
c
b
"}
(7,1,1) = {"
b
a
a
a
m
a
a
a
b
"}
(8,1,1) = {"
b
c
a
g
n
o
a
c
b
"}
(9,1,1) = {"
a
c
a
k
n
p
a
c
b
"}
(10,1,1) = {"
a
c
a
k
n
q
a
c
a
"}
(11,1,1) = {"
a
a
a
a
a
a
a
a
a
"}
(12,1,1) = {"
a
c
a
c
c
c
a
c
a
"}
(13,1,1) = {"
a
a
f
f
f
f
f
a
a
"}
