"a" = (/turf/simulated/wall/untinted/onestar_reinforced,/area/crawler)
"b" = (/obj/crawler/crawler_wallbreaker,/turf/simulated/wall/untinted/onestar_reinforced,/area/crawler)
"c" = (/obj/structure/grille,/turf/simulated/floor/plating/under,/area/crawler)
"d" = (/obj/machinery/porta_turret/stationary,/turf/simulated/floor/plating/under,/area/crawler)
"e" = (/obj/structure/railing/grey,/turf/simulated/floor/plating/under,/area/crawler)
"f" = (/obj/crawler/crawler_wallbreaker/vertical,/turf/simulated/wall/untinted/onestar_reinforced,/area/crawler)
"g" = (/obj/random/mob/roomba,/obj/random/contraband,/turf/simulated/floor/tiled/dark/brown_perforated,/area/crawler)
"h" = (/obj/effect/floor_decal/industrial/danger{dir = 4},/turf/simulated/floor/tiled/dark/cargo,/area/crawler)
"i" = (/obj/structure/catwalk,/turf/simulated/floor/plating/under,/area/crawler)
"j" = (/obj/effect/floor_decal/industrial/danger{dir = 8},/obj/machinery/light/built{dir = 4},/turf/simulated/floor/tiled/dark/brown_platform,/area/crawler)
"k" = (/obj/random/mob/roomba,/obj/random/firstaid,/turf/simulated/floor/tiled/dark/brown_perforated,/area/crawler)
"l" = (/obj/effect/floor_decal/industrial/danger{dir = 8},/turf/simulated/floor/tiled/dark/brown_platform,/area/crawler)
"m" = (/turf/simulated/floor/tiled/dark/cargo,/area/crawler)
"n" = (/obj/random/mob/roomba,/obj/random/contraband,/turf/simulated/floor/tiled/dark/brown_platform,/area/crawler)
"o" = (/obj/structure/table/onestar,/obj/random/gun_energy_cheap,/obj/random/gun_energy_cheap,/obj/random/gun_shotgun,/turf/simulated/floor/tiled/dark/brown_perforated,/area/crawler)
"p" = (/obj/structure/table/onestar,/obj/random/gun_energy_cheap,/obj/random/gun_shotgun,/obj/random/contraband,/turf/simulated/floor/tiled/dark/brown_perforated,/area/crawler)
"q" = (/obj/structure/table/rack,/obj/random/gun_normal,/obj/random/gun_normal,/obj/random/gun_normal/low_chance,/obj/random/gun_shotgun,/turf/simulated/floor/tiled/dark/brown_perforated,/area/crawler)
"s" = (/obj/structure/railing/grey{dir = 1},/turf/simulated/floor/plating/under,/area/crawler)

(1,1,1) = {"
aaaaabbbaaaaa
accdccacccaca
aaeeeaaaaaaaf
fhiiijagkkacf
fhiiilmnnnacf
fhiiijaopqacf
aasssaaaaaaaf
accdccacccaca
aaaabbbbbaaaa
"}
