//MAP CONVERTED BY dmm2tgm.py THIS HEADER COMMENT PREVENTS RECONVERSION, DO NOT REMOVE
"a" = (
/turf/wall/untinted/onestar_reinforced,
/area/crawler)
"b" = (
/obj/crawler/crawler_wallbreaker,
/turf/wall/untinted/onestar_reinforced,
/area/crawler)
"c" = (
/obj/structure/table/rack,
/turf/floor/tiled/white/gray_platform,
/area/crawler)
"d" = (
/turf/floor/tiled/white/gray_platform,
/area/crawler)
"e" = (
/obj/machinery/light/built{
	dir = 1
	},
/turf/floor/tiled/white/gray_platform,
/area/crawler)
"f" = (
/turf/floor/tiled/dark/cargo,
/area/crawler)
"g" = (
/turf/floor/tiled/dark/gray_perforated,
/area/crawler)
"h" = (
/obj/machinery/autolathe,
/turf/floor/tiled/dark/danger,
/area/crawler)
"i" = (
/turf/floor/tiled/dark/danger,
/area/crawler)
"j" = (
/turf/floor/tiled/white/gray_perforated,
/area/crawler)
"k" = (
/turf/floor/tiled/techmaint_cargo,
/area/crawler)
"l" = (
/turf/wall/untinted/onestar,
/area/crawler)
"m" = (
/obj/structure/table/onestar,
/obj/spawner/tool_upgrade/rare/onestar,
/turf/floor/tiled/dark/danger,
/area/crawler)
"n" = (
/obj/structure/bed/chair/custom/onestar,
/turf/floor/tiled/white/gray_perforated,
/area/crawler)
"o" = (
/obj/spawner/mob/roomba,
/turf/floor/tiled/white/gray_platform,
/area/crawler)
"p" = (
/obj/structure/table/onestar,
/turf/floor/tiled/dark/gray_platform,
/area/crawler)
"q" = (
/turf/floor/tiled/dark/gray_platform,
/area/crawler)
"r" = (
/obj/structure/table/reinforced,
/turf/floor/tiled/dark/gray_platform,
/area/crawler)
"s" = (
/obj/structure/salvageable/os/console{
	dir = 1
	},
/turf/floor/tiled/dark/gray_platform,
/area/crawler)
"t" = (
/obj/structure/closet/cabinet,
/obj/spawner/cloth/onestar/low_chance,
/turf/floor/carpet/bcarpet,
/area/crawler)
"u" = (
/turf/floor/carpet/bcarpet,
/area/crawler)
"v" = (
/obj/structure/table/onestar,
/turf/floor/carpet/bcarpet,
/area/crawler)
"w" = (
/obj/item/bedsheet/brown,
/obj/structure/bed,
/turf/floor/carpet/bcarpet,
/area/crawler)
"x" = (
/obj/spawner/mob/roomba,
/turf/floor/tiled/white/gray_perforated,
/area/crawler)
"y" = (
/turf/floor/tiled/techmaint,
/area/crawler)
"z" = (
/obj/crawler/crawler_wallbreaker/vertical,
/turf/wall/untinted/onestar_reinforced,
/area/crawler)
"A" = (
/turf/wall/low/onestar,
/area/crawler)
"B" = (
/obj/machinery/light/built{
	dir = 1
	},
/turf/floor/tiled/dark/gray_perforated,
/area/crawler)
"C" = (
/obj/machinery/light/built,
/turf/floor/carpet/bcarpet,
/area/crawler)
"D" = (
/obj/machinery/light/built,
/turf/floor/tiled/dark/gray_perforated,
/area/crawler)
"E" = (
/obj/spawner/mob/roomba,
/turf/floor/tiled/dark/cargo,
/area/crawler)
"F" = (
/obj/structure/closet/onestar/tier1,
/turf/floor/tiled/white/gray_platform,
/area/crawler)
"G" = (
/obj/structure/closet/onestar/tier2,
/turf/floor/tiled/dark/gray_perforated,
/area/crawler)
"H" = (
/obj/structure/closet/onestar/tier3,
/turf/floor/carpet/bcarpet,
/area/crawler)
"L" = (
/obj/structure/table/reinforced,
/obj/spawner/lathe_disk/advanced/low_chance,
/turf/floor/tiled/dark/gray_platform,
/area/crawler)
"P" = (
/obj/structure/table/rack,
/obj/spawner/lathe_disk/advanced,
/turf/floor/tiled/white/gray_platform,
/area/crawler)

(1,1,1) = {"
a
a
a
a
a
z
a
a
a
"}
(2,1,1) = {"
a
P
h
m
p
l
t
H
a
"}
(3,1,1) = {"
a
e
i
i
q
k
u
C
a
"}
(4,1,1) = {"
a
o
x
j
L
l
v
w
a
"}
(5,1,1) = {"
a
d
x
j
r
l
l
l
b
"}
(6,1,1) = {"
b
d
j
n
s
A
f
f
b
"}
(7,1,1) = {"
b
F
j
j
c
A
f
f
b
"}
(8,1,1) = {"
b
l
y
l
l
l
f
E
b
"}
(9,1,1) = {"
a
f
f
E
f
f
f
E
b
"}
(10,1,1) = {"
a
g
f
E
E
f
E
E
a
"}
(11,1,1) = {"
a
B
f
f
E
f
f
D
a
"}
(12,1,1) = {"
a
G
f
f
f
f
f
g
a
"}
(13,1,1) = {"
a
a
z
z
z
z
z
a
a
"}
