//MAP CONVERTED BY dmm2tgm.py THIS HEADER COMMENT PREVENTS RECONVERSION, DO NOT REMOVE
"a" = (
/turf/wall/untinted/onestar_reinforced,
/area/crawler)
"b" = (
/obj/crawler/crawler_wallbreaker,
/turf/wall/untinted/onestar_reinforced,
/area/crawler)
"c" = (
/obj/structure/railing/grey{
	dir = 4
	},
/turf/floor/plating/under,
/area/crawler)
"d" = (
/turf/floor/tiled/derelict,
/area/crawler)
"e" = (
/obj/effect/floor_decal/industrial/loading{
	dir = 8
	},
/turf/floor/tiled/derelict,
/area/crawler)
"f" = (
/obj/effect/floor_decal/industrial/outline/yellow,
/turf/floor/tiled/derelict,
/area/crawler)
"g" = (
/obj/effect/floor_decal/industrial/hatch/yellow,
/turf/floor/tiled/derelict,
/area/crawler)
"h" = (
/obj/structure/railing/grey{
	dir = 8
	},
/turf/floor/plating/under,
/area/crawler)
"i" = (
/obj/machinery/light/floor,
/obj/structure/railing/grey{
	dir = 4
	},
/obj/structure/railing/grey,
/turf/floor/plating/under,
/area/crawler)
"j" = (
/obj/structure/table/onestar,
/turf/floor/tiled/dark/brown_perforated,
/area/crawler)
"k" = (
/obj/structure/table/onestar,
/obj/structure/window/reinforced{
	dir = 1
	},
/turf/floor/tiled/dark/brown_perforated,
/area/crawler)
"l" = (
/obj/machinery/light/floor,
/obj/structure/railing/grey{
	dir = 8
	},
/obj/structure/railing/grey,
/turf/floor/plating/under,
/area/crawler)
"m" = (
/obj/crawler/crawler_wallbreaker/vertical,
/turf/wall/untinted/onestar_reinforced,
/area/crawler)
"n" = (
/obj/spawner/mob/roomba,
/turf/floor/tiled/derelict,
/area/crawler)
"o" = (
/obj/effect/floor_decal/industrial/warning/corner,
/turf/floor/tiled/derelict,
/area/crawler)
"p" = (
/turf/wall/low/onestar,
/area/crawler)
"q" = (
/turf/floor/tiled/dark/brown_platform,
/area/crawler)
"r" = (
/obj/structure/bed/chair/custom/onestar/red{
	dir = 8
	},
/turf/floor/tiled/dark/brown_platform,
/area/crawler)
"s" = (
/obj/structure/table/rack,
/obj/spawner/gun_parts,
/turf/floor/tiled/dark/brown_platform,
/area/crawler)
"t" = (
/obj/spawner/mob/roomba,
/turf/floor/tiled/dark/brown_platform,
/area/crawler)
"u" = (
/obj/effect/floor_decal/industrial/warning{
	dir = 4
	},
/turf/floor/tiled/derelict,
/area/crawler)
"v" = (
/obj/machinery/door/airlock/centcom,
/turf/floor/tiled/dark/brown_platform,
/area/crawler)
"w" = (
/obj/effect/floor_decal/industrial/warning/corner{
	dir = 4;
	icon_state = "warningcorner"
	},
/turf/floor/tiled/derelict,
/area/crawler)
"x" = (
/obj/structure/bed/chair/custom/onestar/red,
/turf/floor/tiled/dark/brown_platform,
/area/crawler)
"y" = (
/obj/machinery/light/floor,
/obj/structure/railing/grey{
	dir = 1
	},
/obj/structure/railing/grey{
	dir = 4
	},
/turf/floor/plating/under,
/area/crawler)
"z" = (
/obj/structure/table/onestar,
/obj/structure/window/reinforced{
	dir = 6
	},
/turf/floor/tiled/dark/brown_perforated,
/area/crawler)
"A" = (
/obj/machinery/light/floor,
/obj/structure/railing/grey{
	dir = 1
	},
/obj/structure/railing/grey{
	dir = 8
	},
/turf/floor/plating/under,
/area/crawler)
"B" = (
/obj/effect/floor_decal/industrial/loading{
	dir = 4
	},
/turf/floor/tiled/derelict,
/area/crawler)
"C" = (
/turf/wall/untinted/onestar,
/area/crawler)
"D" = (
/obj/structure/closet/onestar/tier3,
/obj/spawner/gun/onestar/low_chance,
/turf/floor/tiled/dark/brown_platform,
/area/crawler)
"N" = (
/obj/structure/table/rack,
/obj/spawner/gun/shotgun/low_chance,
/turf/floor/tiled/dark/brown_platform,
/area/crawler)
"Q" = (
/obj/structure/salvageable/os/console_broken{
	dir = 4
	},
/turf/floor/tiled/dark/brown_platform,
/area/crawler)
"T" = (
/obj/structure/sign/derelict2{
	pixel_x = 32
	},
/turf/floor/tiled/derelict,
/area/crawler)

(1,1,1) = {"
a
a
a
m
m
m
a
a
a
"}
(2,1,1) = {"
a
c
i
d
d
d
y
c
a
"}
(3,1,1) = {"
a
d
d
d
d
d
d
d
a
"}
(4,1,1) = {"
a
d
d
o
u
w
T
f
a
"}
(5,1,1) = {"
a
e
C
p
v
p
C
n
b
"}
(6,1,1) = {"
b
f
j
Q
t
N
C
g
b
"}
(7,1,1) = {"
b
g
k
r
q
x
z
g
b
"}
(8,1,1) = {"
b
g
C
s
q
D
j
f
b
"}
(9,1,1) = {"
a
f
C
p
p
p
C
B
b
"}
(10,1,1) = {"
a
f
d
d
d
d
d
d
a
"}
(11,1,1) = {"
a
n
d
d
d
d
d
d
a
"}
(12,1,1) = {"
a
h
l
d
d
d
A
h
a
"}
(13,1,1) = {"
a
a
m
m
m
m
m
a
a
"}
