//MAP CONVERTED BY dmm2tgm.py THIS HEADER COMMENT PREVENTS RECONVERSION, DO NOT REMOVE
"a" = (
/obj/crawler/crawler_wallbreaker,
/turf/simulated/wall/untinted/onestar_reinforced,
/area/crawler)
"b" = (
/turf/simulated/wall/untinted/onestar,
/area/crawler)
"c" = (
/turf/simulated/floor/tiled/derelict/white_small_edges,
/area/crawler)
"d" = (
/turf/simulated/floor/tiled/derelict,
/area/crawler)
"e" = (
/turf/simulated/floor/tiled/techmaint_panels,
/area/crawler)
"f" = (
/obj/structure/table/onestar,
/turf/simulated/floor/tiled/derelict/red_white_edges,
/area/crawler)
"g" = (
/obj/effect/floor_decal/industrial/loading,
/turf/simulated/floor/tiled/techmaint_cargo,
/area/crawler)
"h" = (
/turf/simulated/wall/untinted/onestar_reinforced,
/area/crawler)
"i" = (
/obj/structure/table/onestar,
/obj/structure/window/reinforced{
	dir = 8
	},
/turf/simulated/floor/tiled/dark/techfloor,
/area/crawler)
"j" = (
/turf/simulated/floor/carpet/bcarpet,
/area/crawler)
"k" = (
/obj/machinery/door/airlock/highsecurity,
/turf/simulated/floor/tiled/dark/techfloor,
/area/crawler)
"l" = (
/turf/simulated/floor/tiled/derelict/red_white_edges,
/area/crawler)
"m" = (
/obj/structure/table/onestar,
/turf/simulated/floor/tiled/dark/techfloor,
/area/crawler)
"n" = (
/obj/structure/table/onestar,
/obj/structure/window/reinforced{
	dir = 4
	},
/turf/simulated/floor/tiled/dark/techfloor,
/area/crawler)
"o" = (
/obj/effect/floor_decal/industrial/loading{
	dir = 1
	},
/turf/simulated/floor/tiled/techmaint_cargo,
/area/crawler)
"p" = (
/obj/effect/floor_decal/industrial/outline/yellow,
/turf/simulated/floor/tiled/techmaint_cargo,
/area/crawler)
"q" = (
/obj/structure/closet/onestar/tier2,
/turf/simulated/floor/tiled/derelict/red_white_edges,
/area/crawler)
"r" = (
/obj/effect/floor_decal/industrial/danger,
/turf/simulated/floor/tiled/derelict/white_small_edges,
/area/crawler)
"s" = (
/obj/crawler/crawler_wallbreaker/vertical,
/turf/simulated/wall/untinted/onestar_reinforced,
/area/crawler)
"t" = (
/obj/random/mob/roomba,
/turf/simulated/floor/tiled/derelict/white_small_edges,
/area/crawler)
"u" = (
/obj/structure/bed/chair/custom/onestar{
	dir = 8
	},
/turf/simulated/floor/carpet/bcarpet,
/area/crawler)
"v" = (
/obj/effect/floor_decal/industrial/outline,
/turf/simulated/floor/tiled/techmaint_cargo,
/area/crawler)
"w" = (
/obj/structure/bed/chair/custom/onestar{
	dir = 4
	},
/turf/simulated/floor/carpet/bcarpet,
/area/crawler)
"x" = (
/obj/effect/floor_decal/industrial/danger{
	dir = 1
	},
/turf/simulated/floor/tiled/derelict/white_small_edges,
/area/crawler)
"y" = (
/obj/random/mob/roomba,
/turf/simulated/floor/tiled/techmaint_cargo,
/area/crawler)

(1,1,1) = {"
h
h
h
h
h
s
h
h
h
"}
(2,1,1) = {"
h
c
r
b
l
l
l
l
h
"}
(3,1,1) = {"
h
t
c
k
l
j
j
f
h
"}
(4,1,1) = {"
h
c
r
b
l
j
w
f
h
"}
(5,1,1) = {"
a
d
b
b
b
m
n
b
a
"}
(6,1,1) = {"
a
e
g
p
p
v
g
e
a
"}
(7,1,1) = {"
a
d
b
b
b
b
b
d
a
"}
(8,1,1) = {"
a
e
o
v
y
p
o
e
a
"}
(9,1,1) = {"
a
b
i
m
b
b
b
d
a
"}
(10,1,1) = {"
h
f
u
j
l
b
x
c
h
"}
(11,1,1) = {"
h
f
j
j
l
k
c
t
h
"}
(12,1,1) = {"
h
q
l
l
l
b
x
c
h
"}
(13,1,1) = {"
h
h
s
s
s
s
s
h
h
"}
