//MAP CONVERTED BY dmm2tgm.py THIS HEADER COMMENT PREVENTS RECONVERSION, DO NOT REMOVE
"a" = (
/obj/crawler/crawler_wallbreaker,
/turf/wall/untinted/onestar_reinforced,
/area/crawler)
"b" = (
/turf/wall/untinted/onestar,
/area/crawler)
"c" = (
/turf/floor/tiled/derelict/white_small_edges,
/area/crawler)
"d" = (
/turf/floor/tiled/derelict,
/area/crawler)
"e" = (
/turf/floor/tiled/techmaint_panels,
/area/crawler)
"f" = (
/obj/structure/table/onestar,
/turf/floor/tiled/derelict/red_white_edges,
/area/crawler)
"g" = (
/obj/effect/floor_decal/industrial/loading,
/turf/floor/tiled/techmaint_cargo,
/area/crawler)
"h" = (
/turf/wall/untinted/onestar_reinforced,
/area/crawler)
"i" = (
/obj/structure/table/onestar,
/obj/item/oddity/common/old_id,
/turf/floor/tiled/dark/techfloor,
/area/crawler)
"j" = (
/turf/floor/carpet/bcarpet,
/area/crawler)
"k" = (
/obj/machinery/door/airlock/highsecurity,
/turf/floor/tiled/dark/techfloor,
/area/crawler)
"l" = (
/turf/floor/tiled/derelict/red_white_edges,
/area/crawler)
"m" = (
/obj/structure/table/onestar,
/obj/structure/window/reinforced{
	dir = 8
	},
/turf/floor/tiled/dark/techfloor,
/area/crawler)
"n" = (
/obj/structure/table/onestar,
/obj/item/stack/os_cash,
/turf/floor/tiled/dark/techfloor,
/area/crawler)
"o" = (
/obj/effect/floor_decal/industrial/loading{
	dir = 1
	},
/turf/floor/tiled/techmaint_cargo,
/area/crawler)
"p" = (
/obj/effect/floor_decal/industrial/outline/yellow,
/turf/floor/tiled/techmaint_cargo,
/area/crawler)
"q" = (
/obj/structure/closet/onestar/tier2,
/obj/spawner/cloth/onestar,
/turf/floor/tiled/derelict/red_white_edges,
/area/crawler)
"r" = (
/obj/effect/floor_decal/industrial/danger,
/turf/floor/tiled/derelict/white_small_edges,
/area/crawler)
"s" = (
/obj/crawler/crawler_wallbreaker/vertical,
/turf/wall/untinted/onestar_reinforced,
/area/crawler)
"t" = (
/obj/spawner/mob/roomba,
/turf/floor/tiled/derelict/white_small_edges,
/area/crawler)
"u" = (
/obj/structure/bed/chair/custom/onestar{
	dir = 8
	},
/turf/floor/carpet/bcarpet,
/area/crawler)
"v" = (
/obj/effect/floor_decal/industrial/outline,
/turf/floor/tiled/techmaint_cargo,
/area/crawler)
"w" = (
/obj/structure/bed/chair/custom/onestar{
	dir = 4
	},
/turf/floor/carpet/bcarpet,
/area/crawler)
"x" = (
/obj/effect/floor_decal/industrial/danger{
	dir = 1
	},
/turf/floor/tiled/derelict/white_small_edges,
/area/crawler)
"y" = (
/obj/spawner/mob/roomba,
/obj/structure/sign/derelict1{
	pixel_x = 32
	},
/turf/floor/tiled/techmaint_cargo,
/area/crawler)
"E" = (
/obj/structure/table/onestar,
/obj/structure/window/reinforced{
	dir = 4
	},
/turf/floor/tiled/dark/techfloor,
/area/crawler)
"F" = (
/obj/item/storage/briefcase{
	pixel_x = -4;
	pixel_y = 18
	},
/turf/floor/tiled/derelict,
/area/crawler)
"M" = (
/obj/structure/closet/onestar/tier2,
/obj/spawner/firstaid/low_chance,
/obj/spawner/cloth/onestar/low_chance,
/turf/floor/tiled/derelict/red_white_edges,
/area/crawler)
"Q" = (
/obj/effect/floor_decal/industrial/outline/yellow,
/obj/structure/sign/derelict2{
	pixel_x = -32
	},
/turf/floor/tiled/techmaint_cargo,
/area/crawler)
"U" = (
/obj/structure/salvageable/os/console_broken{
	dir = 1
	},
/turf/floor/tiled/derelict/red_white_edges,
/area/crawler)
"X" = (
/obj/structure/salvageable/os/console_broken,
/turf/floor/tiled/derelict/red_white_edges,
/area/crawler)

(1,1,1) = {"
h
h
h
h
h
s
h
h
h
"}
(2,1,1) = {"
h
c
r
b
l
l
l
M
h
"}
(3,1,1) = {"
h
t
c
k
l
j
j
f
h
"}
(4,1,1) = {"
h
c
r
b
l
j
w
U
h
"}
(5,1,1) = {"
a
d
b
b
b
E
n
b
a
"}
(6,1,1) = {"
a
e
g
p
Q
v
g
e
a
"}
(7,1,1) = {"
a
d
b
b
b
b
b
F
a
"}
(8,1,1) = {"
a
e
o
v
y
p
o
e
a
"}
(9,1,1) = {"
a
b
i
m
b
b
b
d
a
"}
(10,1,1) = {"
h
X
u
j
l
b
x
c
h
"}
(11,1,1) = {"
h
f
j
j
l
k
c
t
h
"}
(12,1,1) = {"
h
q
l
l
l
b
x
c
h
"}
(13,1,1) = {"
h
h
s
s
s
s
s
h
h
"}
