//MAP CONVERTED BY dmm2tgm.py THIS HEADER COMMENT PREVENTS RECONVERSION, DO NOT REMOVE
"a" = (
/turf/wall/untinted/onestar_reinforced,
/area/crawler)
"b" = (
/obj/crawler/crawler_wallbreaker,
/turf/wall/untinted/onestar_reinforced,
/area/crawler)
"c" = (
/turf/floor/tiled/derelict/white_small_edges,
/area/crawler)
"d" = (
/obj/structure/window/reinforced{
	dir = 6
	},
/turf/floor/tiled/derelict/white_small_edges,
/area/crawler)
"e" = (
/obj/structure/catwalk,
/turf/floor/plating/under,
/area/crawler)
"f" = (
/obj/structure/catwalk,
/obj/machinery/light/floor,
/turf/floor/plating/under,
/area/crawler)
"g" = (
/obj/structure/window/reinforced{
	dir = 4
	},
/turf/floor/tiled/derelict/white_small_edges,
/area/crawler)
"h" = (
/obj/machinery/power/breakerbox/activated,
/turf/floor/tiled/techmaint_panels,
/area/crawler)
"i" = (
/obj/structure/salvageable/os/computer,
/turf/floor/tiled/techmaint_panels,
/area/crawler)
"j" = (
/obj/structure/window/reinforced{
	dir = 8
	},
/turf/floor/tiled/derelict/white_small_edges,
/area/crawler)
"k" = (
/obj/structure/disposalpipe/segment{
	dir = 4
	},
/obj/structure/lattice,
/turf/floor/plating/under,
/area/crawler)
"l" = (
/obj/structure/railing/grey,
/obj/structure/disposalpipe/segment{
	dir = 4
	},
/obj/structure/lattice,
/turf/floor/plating/under,
/area/crawler)
"m" = (
/obj/crawler/crawler_wallbreaker/vertical,
/turf/wall/untinted/onestar_reinforced,
/area/crawler)
"n" = (
/obj/effect/floor_decal/industrial/warning{
	dir = 1
	},
/turf/floor/tiled/derelict,
/area/crawler)
"o" = (
/turf/floor/bluegrid,
/area/crawler)
"p" = (
/obj/effect/floor_decal/industrial/warning{
	dir = 1
	},
/obj/machinery/light/floor,
/obj/structure/sign/derelict1{
	pixel_x = 32
	},
/turf/floor/tiled/derelict,
/area/crawler)
"q" = (
/obj/crawler/crawler_wallbreaker/vertical,
/turf/floor/bluegrid,
/area/crawler)
"r" = (
/obj/machinery/power/terminal,
/obj/structure/catwalk,
/turf/floor/tiled/derelict/white_small_edges,
/area/crawler)
"s" = (
/obj/machinery/power/smes/buildable,
/turf/floor/tiled/techmaint_panels,
/area/crawler)
"t" = (
/turf/floor/tiled/derelict,
/area/crawler)
"u" = (
/obj/effect/floor_decal/industrial/warning{
	dir = 4
	},
/obj/machinery/light/floor,
/turf/floor/tiled/derelict,
/area/crawler)
"v" = (
/obj/structure/window/reinforced{
	dir = 4
	},
/obj/structure/railing/grey{
	dir = 8
	},
/turf/floor/tiled/derelict/white_small_edges,
/area/crawler)
"w" = (
/obj/structure/window/reinforced{
	dir = 8
	},
/obj/machinery/light/floor,
/turf/floor/tiled/derelict/white_small_edges,
/area/crawler)
"x" = (
/obj/machinery/light/floor,
/turf/floor/tiled/derelict,
/area/crawler)
"y" = (
/obj/effect/floor_decal/industrial/warning{
	dir = 4
	},
/turf/floor/tiled/derelict,
/area/crawler)
"z" = (
/obj/effect/floor_decal/industrial/loading{
	dir = 4
	},
/turf/floor/tiled/derelict/white_small_edges,
/area/crawler)
"A" = (
/obj/structure/grille,
/turf/floor/tiled/techmaint,
/area/crawler)
"C" = (
/obj/crawler/crawler_wallbreaker,
/turf/floor/bluegrid,
/area/crawler)
"D" = (
/obj/structure/railing/grey{
	dir = 8
	},
/turf/floor/tiled/derelict/white_small_edges,
/area/crawler)
"F" = (
/obj/spawner/mob/roomba,
/turf/floor/tiled/derelict,
/area/crawler)
"W" = (
/obj/machinery/power/port_gen/os_generator,
/turf/floor/tiled/techmaint_panels,
/area/crawler)

(1,1,1) = {"
a
a
a
o
o
q
a
a
a
"}
(2,1,1) = {"
a
f
l
n
t
t
A
k
a
"}
(3,1,1) = {"
a
e
l
n
t
t
A
k
a
"}
(4,1,1) = {"
a
e
l
n
F
t
A
k
a
"}
(5,1,1) = {"
a
e
l
n
t
x
a
A
b
"}
(6,1,1) = {"
b
e
l
n
t
t
x
t
C
"}
(7,1,1) = {"
b
e
l
p
t
t
t
t
C
"}
(8,1,1) = {"
b
e
k
a
u
y
y
y
C
"}
(9,1,1) = {"
a
c
g
c
v
z
v
D
b
"}
(10,1,1) = {"
a
d
h
r
s
r
W
c
a
"}
(11,1,1) = {"
a
d
i
r
s
r
W
c
a
"}
(12,1,1) = {"
a
c
j
c
w
c
j
c
a
"}
(13,1,1) = {"
a
a
m
m
m
m
m
a
a
"}
