"a" = (/turf/simulated/wall/untinted/onestar_reinforced,/area/crawler)
"b" = (/obj/crawler/crawler_wallbreaker,/turf/simulated/wall/untinted/onestar_reinforced,/area/crawler)
"c" = (/turf/simulated/floor/grass,/area/crawler)
"d" = (/obj/structure/inflatable/wall,/turf/simulated/floor/grass,/area/crawler)
"e" = (/turf/simulated/floor/dirt,/area/crawler)
"f" = (/obj/structure/railing/grey,/turf/simulated/floor/grass,/area/crawler)
"g" = (/obj/machinery/light/floor,/turf/simulated/floor/grass,/area/crawler)
"h" = (/obj/crawler/crawler_wallbreaker/vertical,/turf/simulated/wall/untinted/onestar_reinforced,/area/crawler)
"i" = (/turf/simulated/floor/bluegrid,/area/crawler)
"j" = (/obj/effect/floor_decal/grass_edge{dir = 1},/turf/simulated/floor/tiled/derelict,/area/crawler)
"k" = (/obj/effect/floor_decal/grass_edge{dir = 1},/obj/machinery/light/floor,/turf/simulated/floor/tiled/derelict,/area/crawler)
"l" = (/obj/effect/floor_decal/grass_edge{dir = 4},/obj/machinery/light/floor,/turf/simulated/floor/tiled/derelict,/area/crawler)
"m" = (/obj/structure/inflatable/door,/turf/simulated/floor/grass,/area/crawler)
"n" = (/turf/simulated/floor/tiled/derelict,/area/crawler)
"o" = (/obj/machinery/light/floor,/turf/simulated/floor/tiled/derelict,/area/crawler)
"p" = (/obj/structure/railing/grey{dir = 8},/turf/simulated/floor/grass,/area/crawler)
"q" = (/obj/crawler/crawler_wallbreaker/vertical,/turf/simulated/floor/bluegrid,/area/crawler)
"r" = (/obj/effect/floor_decal/grass_edge,/turf/simulated/floor/tiled/derelict,/area/crawler)
"t" = (/obj/effect/floor_decal/grass_edge{dir = 4},/turf/simulated/floor/tiled/derelict,/area/crawler)
"u" = (/obj/structure/railing/grey{dir = 1},/obj/structure/flora/ausbushes/ppflowers,/obj/structure/flora/ausbushes/sparsegrass,/turf/simulated/floor/grass,/area/crawler)
"v" = (/obj/structure/railing/grey{dir = 1},/obj/structure/flora/ausbushes/ppflowers,/turf/simulated/floor/grass,/area/crawler)
"w" = (/obj/structure/railing/grey{dir = 1},/obj/structure/flora/ausbushes/brflowers,/obj/structure/flora/ausbushes/ppflowers,/turf/simulated/floor/grass,/area/crawler)
"y" = (/obj/structure/flora/ausbushes/sparsegrass,/turf/simulated/floor/grass,/area/crawler)
"z" = (/obj/structure/flora/ausbushes/ppflowers,/obj/structure/flora/ausbushes/sparsegrass,/turf/simulated/floor/grass,/area/crawler)
"A" = (/obj/structure/flora/ausbushes/ppflowers,/turf/simulated/floor/grass,/area/crawler)
"B" = (/obj/structure/railing/grey{dir = 4},/obj/structure/flora/ausbushes/brflowers,/turf/simulated/floor/grass,/area/crawler)
"C" = (/obj/effect/floor_decal/grass_edge{dir = 8},/turf/simulated/floor/tiled/derelict,/area/crawler)
"D" = (/obj/crawler/crawler_wallbreaker,/turf/simulated/floor/bluegrid,/area/crawler)

(1,1,1) = {"
aaaaabbbaaaaa
acccccccdeeea
affffffgddeeh
ijjjjjkagdmdh
innnnnnlpccch
qrrronntpccch
auvwaontpccch
ayzABCntpccca
aaaabDDDbaaaa
"}
