"a" = (/turf/simulated/wall/untinted/onestar_reinforced,/area/crawler)
"b" = (/obj/crawler/crawler_wallbreaker,/turf/simulated/floor/bluegrid,/area/crawler)
"c" = (/turf/simulated/floor/tiled/derelict/white_small_edges,/area/crawler)
"d" = (/obj/structure/window/reinforced{dir = 6},/turf/simulated/floor/tiled/derelict/white_small_edges,/area/crawler)
"e" = (/obj/structure/railing/grey{dir = 4},/turf/simulated/floor/tiled/derelict/white_small_edges,/area/crawler)
"f" = (/obj/effect/floor_decal/industrial/warning{dir = 8},/turf/simulated/floor/tiled/derelict,/area/crawler)
"g" = (/turf/simulated/floor/tiled/derelict,/area/crawler)
"h" = (/obj/structure/grille,/turf/simulated/floor/tiled/techmaint,/area/crawler)
"i" = (/obj/structure/disposalpipe/segment{dir = 4},/obj/structure/lattice,/turf/simulated/floor/plating/under,/area/crawler)
"j" = (/obj/structure/window/reinforced{dir = 4},/turf/simulated/floor/tiled/derelict/white_small_edges,/area/crawler)
"k" = (/obj/machinery/power/breakerbox/activated,/turf/simulated/floor/tiled/techmaint_panels,/area/crawler)
"l" = (/obj/structure/computerframe,/turf/simulated/floor/tiled/techmaint_panels,/area/crawler)
"m" = (/obj/structure/window/reinforced{dir = 8},/obj/structure/railing/grey{dir = 4},/turf/simulated/floor/tiled/derelict/white_small_edges,/area/crawler)
"n" = (/obj/machinery/light/floor,/turf/simulated/floor/tiled/derelict,/area/crawler)
"o" = (/obj/crawler/crawler_wallbreaker/vertical,/turf/simulated/wall/untinted/onestar_reinforced,/area/crawler)
"p" = (/obj/machinery/power/terminal,/obj/structure/catwalk,/turf/simulated/floor/tiled/derelict/white_small_edges,/area/crawler)
"q" = (/obj/effect/floor_decal/industrial/loading{dir = 8},/turf/simulated/floor/tiled/derelict/white_small_edges,/area/crawler)
"r" = (/obj/structure/window/reinforced{dir = 4},/obj/machinery/light/floor,/turf/simulated/floor/tiled/derelict/white_small_edges,/area/crawler)
"s" = (/obj/crawler/crawler_wallbreaker/vertical,/turf/simulated/floor/bluegrid,/area/crawler)
"t" = (/obj/effect/floor_decal/industrial/warning{dir = 8},/obj/machinery/light/floor,/turf/simulated/floor/tiled/derelict,/area/crawler)
"u" = (/obj/machinery/power/smes/buildable,/turf/simulated/floor/tiled/techmaint_panels,/area/crawler)
"v" = (/obj/effect/floor_decal/industrial/warning,/obj/machinery/light/floor,/turf/simulated/floor/tiled/derelict,/area/crawler)
"w" = (/obj/structure/catwalk,/obj/machinery/light/floor,/turf/simulated/floor/plating/under,/area/crawler)
"x" = (/obj/effect/floor_decal/industrial/warning,/turf/simulated/floor/tiled/derelict,/area/crawler)
"y" = (/obj/structure/window/reinforced{dir = 8},/turf/simulated/floor/tiled/derelict/white_small_edges,/area/crawler)
"z" = (/obj/structure/railing/grey{dir = 1},/obj/structure/disposalpipe/segment{dir = 4},/obj/structure/lattice,/turf/simulated/floor/plating/under,/area/crawler)
"A" = (/obj/structure/catwalk,/turf/simulated/floor/plating/under,/area/crawler)
"C" = (/obj/crawler/crawler_wallbreaker,/turf/simulated/wall/untinted/onestar_reinforced,/area/crawler)

(1,1,1) = {"
aaaaabbbaaaaa
acddefgghiiia
ajklmfgnahhho
acppqfggngggs
aruumtggggggs
ocppcavxxxxxs
ajuuyizzzzzzo
accccAAAAAAwa
aaaaCCCCCaaaa
"}
