//MAP CONVERTED BY dmm2tgm.py THIS HEADER COMMENT PREVENTS RECONVERSION, DO NOT REMOVE
"a" = (
/turf/wall/untinted/onestar_reinforced,
/area/crawler)
"b" = (
/obj/crawler/crawler_wallbreaker,
/turf/floor/bluegrid,
/area/crawler)
"c" = (
/turf/floor/tiled/derelict,
/area/crawler)
"d" = (
/obj/effect/floor_decal/industrial/warning{
	dir = 4
	},
/turf/floor/tiled/derelict,
/area/crawler)
"e" = (
/obj/structure/railing/grey{
	dir = 8
	},
/turf/floor/tiled/derelict/white_small_edges,
/area/crawler)
"f" = (
/obj/structure/window/reinforced{
	dir = 6
	},
/turf/floor/tiled/derelict/white_small_edges,
/area/crawler)
"g" = (
/turf/floor/tiled/derelict/white_small_edges,
/area/crawler)
"h" = (
/obj/structure/grille,
/turf/floor/tiled/techmaint,
/area/crawler)
"i" = (
/obj/structure/disposalpipe/segment{
	dir = 4
	},
/obj/structure/lattice,
/turf/floor/plating/under,
/area/crawler)
"j" = (
/obj/machinery/light/floor,
/turf/floor/tiled/derelict,
/area/crawler)
"k" = (
/obj/machinery/power/breakerbox/activated,
/turf/floor/tiled/techmaint_panels,
/area/crawler)
"l" = (
/obj/machinery/power/port_gen/os_generator,
/turf/floor/tiled/techmaint_panels,
/area/crawler)
"m" = (
/obj/structure/window/reinforced{
	dir = 4
	},
/obj/structure/railing/grey{
	dir = 8
	},
/turf/floor/tiled/derelict/white_small_edges,
/area/crawler)
"n" = (
/obj/structure/window/reinforced{
	dir = 8
	},
/turf/floor/tiled/derelict/white_small_edges,
/area/crawler)
"o" = (
/obj/crawler/crawler_wallbreaker/vertical,
/turf/wall/untinted/onestar_reinforced,
/area/crawler)
"p" = (
/obj/effect/floor_decal/industrial/warning{
	dir = 4
	},
/obj/machinery/light/floor,
/turf/floor/tiled/derelict,
/area/crawler)
"q" = (
/turf/floor/bluegrid,
/area/crawler)
"r" = (
/obj/effect/floor_decal/industrial/loading{
	dir = 4
	},
/turf/floor/tiled/derelict/white_small_edges,
/area/crawler)
"s" = (
/obj/crawler/crawler_wallbreaker/vertical,
/turf/floor/bluegrid,
/area/crawler)
"t" = (
/obj/machinery/power/terminal,
/obj/structure/catwalk,
/turf/floor/tiled/derelict/white_small_edges,
/area/crawler)
"u" = (
/obj/machinery/power/smes/buildable,
/turf/floor/tiled/techmaint_panels,
/area/crawler)
"v" = (
/obj/structure/window/reinforced{
	dir = 8
	},
/obj/machinery/light/floor,
/turf/floor/tiled/derelict/white_small_edges,
/area/crawler)
"w" = (
/obj/effect/floor_decal/industrial/warning,
/obj/machinery/light/floor,
/turf/floor/tiled/derelict,
/area/crawler)
"x" = (
/obj/effect/floor_decal/industrial/warning,
/turf/floor/tiled/derelict,
/area/crawler)
"y" = (
/obj/structure/catwalk,
/obj/machinery/light/floor,
/turf/floor/plating/under,
/area/crawler)
"z" = (
/obj/structure/railing/grey{
	dir = 1
	},
/obj/structure/disposalpipe/segment{
	dir = 4
	},
/obj/structure/lattice,
/turf/floor/plating/under,
/area/crawler)
"A" = (
/obj/structure/catwalk,
/turf/floor/plating/under,
/area/crawler)
"B" = (
/obj/structure/window/reinforced{
	dir = 4
	},
/turf/floor/tiled/derelict/white_small_edges,
/area/crawler)
"C" = (
/obj/crawler/crawler_wallbreaker,
/turf/wall/untinted/onestar_reinforced,
/area/crawler)

(1,1,1) = {"
a
a
a
q
q
s
a
a
a
"}
(2,1,1) = {"
a
i
h
c
c
x
z
y
a
"}
(3,1,1) = {"
a
i
h
c
c
x
z
A
a
"}
(4,1,1) = {"
a
i
h
c
c
x
z
A
a
"}
(5,1,1) = {"
a
h
a
j
c
x
z
A
C
"}
(6,1,1) = {"
b
c
j
c
c
x
z
A
C
"}
(7,1,1) = {"
b
c
c
c
c
w
z
A
C
"}
(8,1,1) = {"
b
d
d
d
p
a
i
A
C
"}
(9,1,1) = {"
a
e
m
r
m
g
B
g
C
"}
(10,1,1) = {"
a
f
k
t
u
t
u
g
a
"}
(11,1,1) = {"
a
f
l
t
u
t
u
g
a
"}
(12,1,1) = {"
a
g
n
g
v
g
n
g
a
"}
(13,1,1) = {"
a
a
o
o
o
o
o
a
a
"}
