"a" = (/turf/simulated/wall/untinted/onestar_reinforced,/area/crawler)
"b" = (/obj/crawler/crawler_wallbreaker,/turf/simulated/wall/untinted/onestar_reinforced,/area/crawler)
"c" = (/turf/simulated/floor/tiled/derelict/white_small_edges,/area/crawler)
"d" = (/obj/structure/window/reinforced{dir = 6},/turf/simulated/floor/tiled/derelict/white_small_edges,/area/crawler)
"e" = (/obj/structure/catwalk,/turf/simulated/floor/plating/under,/area/crawler)
"f" = (/obj/structure/catwalk,/obj/machinery/light/floor,/turf/simulated/floor/plating/under,/area/crawler)
"g" = (/obj/structure/window/reinforced{dir = 4},/turf/simulated/floor/tiled/derelict/white_small_edges,/area/crawler)
"h" = (/obj/machinery/power/breakerbox/activated,/turf/simulated/floor/tiled/techmaint_panels,/area/crawler)
"i" = (/obj/structure/computerframe,/turf/simulated/floor/tiled/techmaint_panels,/area/crawler)
"j" = (/obj/structure/window/reinforced{dir = 8},/turf/simulated/floor/tiled/derelict/white_small_edges,/area/crawler)
"k" = (/obj/structure/disposalpipe/segment{dir = 4},/obj/structure/lattice,/turf/simulated/floor/plating/under,/area/crawler)
"l" = (/obj/structure/railing/grey,/obj/structure/disposalpipe/segment{dir = 4},/obj/structure/lattice,/turf/simulated/floor/plating/under,/area/crawler)
"m" = (/obj/crawler/crawler_wallbreaker/vertical,/turf/simulated/wall/untinted/onestar_reinforced,/area/crawler)
"n" = (/obj/machinery/power/terminal,/obj/structure/catwalk,/turf/simulated/floor/tiled/derelict/white_small_edges,/area/crawler)
"o" = (/obj/effect/floor_decal/industrial/warning{dir = 1},/obj/machinery/light/floor,/turf/simulated/floor/tiled/derelict,/area/crawler)
"p" = (/obj/effect/floor_decal/industrial/warning{dir = 1},/turf/simulated/floor/tiled/derelict,/area/crawler)
"q" = (/obj/crawler/crawler_wallbreaker/vertical,/turf/simulated/floor/bluegrid,/area/crawler)
"r" = (/obj/structure/window/reinforced{dir = 4},/obj/machinery/light/floor,/turf/simulated/floor/tiled/derelict/white_small_edges,/area/crawler)
"s" = (/obj/machinery/power/smes/buildable,/turf/simulated/floor/tiled/techmaint_panels,/area/crawler)
"t" = (/obj/structure/window/reinforced{dir = 8},/obj/structure/railing/grey{dir = 4},/turf/simulated/floor/tiled/derelict/white_small_edges,/area/crawler)
"u" = (/obj/effect/floor_decal/industrial/warning{dir = 8},/obj/machinery/light/floor,/turf/simulated/floor/tiled/derelict,/area/crawler)
"v" = (/turf/simulated/floor/tiled/derelict,/area/crawler)
"w" = (/obj/effect/floor_decal/industrial/loading{dir = 8},/turf/simulated/floor/tiled/derelict/white_small_edges,/area/crawler)
"x" = (/obj/effect/floor_decal/industrial/warning{dir = 8},/turf/simulated/floor/tiled/derelict,/area/crawler)
"y" = (/obj/machinery/light/floor,/turf/simulated/floor/tiled/derelict,/area/crawler)
"A" = (/obj/structure/grille,/turf/simulated/floor/tiled/techmaint,/area/crawler)
"B" = (/obj/structure/railing/grey{dir = 4},/turf/simulated/floor/tiled/derelict/white_small_edges,/area/crawler)
"C" = (/obj/crawler/crawler_wallbreaker,/turf/simulated/floor/bluegrid,/area/crawler)

(1,1,1) = {"
aaaaabbbaaaaa
acddceeeeeefa
aghijkllllllm
acnncaopppppq
arsstuvvvvvvq
mcnnwxvvyvvvq
agsstxvyaAAAm
acccBxvvAkkka
aaaabCCCbaaaa
"}
