//MAP CONVERTED BY dmm2tgm.py THIS HEADER COMMENT PREVENTS RECONVERSION, DO NOT REMOVE
"a" = (
/turf/wall/untinted/onestar_reinforced,
/area/crawler)
"b" = (
/obj/crawler/crawler_wallbreaker,
/turf/wall/untinted/onestar_reinforced,
/area/crawler)
"c" = (
/turf/floor/tiled/derelict/white_small_edges,
/area/crawler)
"d" = (
/obj/structure/window/reinforced{
	dir = 6
	},
/turf/floor/tiled/derelict/white_small_edges,
/area/crawler)
"e" = (
/obj/structure/catwalk,
/turf/floor/plating/under,
/area/crawler)
"f" = (
/obj/structure/catwalk,
/obj/machinery/light/floor,
/turf/floor/plating/under,
/area/crawler)
"g" = (
/obj/structure/window/reinforced{
	dir = 4
	},
/turf/floor/tiled/derelict/white_small_edges,
/area/crawler)
"h" = (
/obj/machinery/power/breakerbox/activated,
/turf/floor/tiled/techmaint_panels,
/area/crawler)
"i" = (
/obj/machinery/power/port_gen/os_generator,
/turf/floor/tiled/techmaint_panels,
/area/crawler)
"j" = (
/obj/structure/window/reinforced{
	dir = 8
	},
/turf/floor/tiled/derelict/white_small_edges,
/area/crawler)
"k" = (
/obj/structure/disposalpipe/segment{
	dir = 4
	},
/obj/structure/lattice,
/turf/floor/plating/under,
/area/crawler)
"l" = (
/obj/structure/railing/grey,
/obj/structure/disposalpipe/segment{
	dir = 4
	},
/obj/structure/lattice,
/turf/floor/plating/under,
/area/crawler)
"m" = (
/obj/crawler/crawler_wallbreaker/vertical,
/turf/wall/untinted/onestar_reinforced,
/area/crawler)
"n" = (
/obj/machinery/power/terminal,
/obj/structure/catwalk,
/turf/floor/tiled/derelict/white_small_edges,
/area/crawler)
"o" = (
/obj/effect/floor_decal/industrial/warning{
	dir = 1
	},
/obj/machinery/light/floor,
/turf/floor/tiled/derelict,
/area/crawler)
"p" = (
/obj/effect/floor_decal/industrial/warning{
	dir = 1
	},
/turf/floor/tiled/derelict,
/area/crawler)
"q" = (
/obj/crawler/crawler_wallbreaker/vertical,
/turf/floor/bluegrid,
/area/crawler)
"r" = (
/obj/structure/window/reinforced{
	dir = 4
	},
/obj/machinery/light/floor,
/turf/floor/tiled/derelict/white_small_edges,
/area/crawler)
"s" = (
/obj/machinery/power/smes/buildable,
/turf/floor/tiled/techmaint_panels,
/area/crawler)
"t" = (
/obj/structure/window/reinforced{
	dir = 8
	},
/obj/structure/railing/grey{
	dir = 4
	},
/turf/floor/tiled/derelict/white_small_edges,
/area/crawler)
"u" = (
/obj/effect/floor_decal/industrial/warning{
	dir = 8
	},
/obj/machinery/light/floor,
/turf/floor/tiled/derelict,
/area/crawler)
"v" = (
/turf/floor/tiled/derelict,
/area/crawler)
"w" = (
/obj/effect/floor_decal/industrial/loading{
	dir = 8
	},
/turf/floor/tiled/derelict/white_small_edges,
/area/crawler)
"x" = (
/obj/effect/floor_decal/industrial/warning{
	dir = 8
	},
/turf/floor/tiled/derelict,
/area/crawler)
"y" = (
/obj/machinery/light/floor,
/turf/floor/tiled/derelict,
/area/crawler)
"A" = (
/obj/structure/grille,
/turf/floor/tiled/techmaint,
/area/crawler)
"B" = (
/obj/structure/railing/grey{
	dir = 4
	},
/turf/floor/tiled/derelict/white_small_edges,
/area/crawler)
"C" = (
/obj/crawler/crawler_wallbreaker,
/turf/floor/bluegrid,
/area/crawler)
"Y" = (
/obj/spawner/mob/roomba,
/turf/floor/tiled/derelict,
/area/crawler)

(1,1,1) = {"
a
a
a
a
a
m
a
a
a
"}
(2,1,1) = {"
a
c
g
c
r
c
g
c
a
"}
(3,1,1) = {"
a
d
h
n
s
n
s
c
a
"}
(4,1,1) = {"
a
d
i
n
s
n
s
c
a
"}
(5,1,1) = {"
a
c
j
c
t
w
t
B
b
"}
(6,1,1) = {"
b
e
k
a
u
x
x
x
C
"}
(7,1,1) = {"
b
e
l
o
v
v
v
v
C
"}
(8,1,1) = {"
b
e
l
p
Y
v
y
v
C
"}
(9,1,1) = {"
a
e
l
p
v
y
a
A
b
"}
(10,1,1) = {"
a
e
l
p
v
v
A
k
a
"}
(11,1,1) = {"
a
e
l
p
v
v
A
k
a
"}
(12,1,1) = {"
a
f
l
p
v
v
A
k
a
"}
(13,1,1) = {"
a
a
m
q
q
q
m
a
a
"}
