//MAP CONVERTED BY dmm2tgm.py THIS HEADER COMMENT PREVENTS RECONVERSION, DO NOT REMOVE
"a" = (
/turf/wall/untinted/onestar_reinforced,
/area/crawler)
"b" = (
/obj/crawler/crawler_wallbreaker,
/turf/wall/untinted/onestar_reinforced,
/area/crawler)
"c" = (
/turf/floor/tiled/dark/techfloor,
/area/crawler)
"d" = (
/turf/floor/plating/under,
/area/crawler)
"e" = (
/turf/floor/tiled/derelict/white_small_edges,
/area/crawler)
"f" = (
/obj/structure/lattice,
/turf/wall/low/onestar,
/area/crawler)
"g" = (
/obj/crawler/crawler_wallbreaker/vertical,
/turf/wall/untinted/onestar_reinforced,
/area/crawler)
"h" = (
/turf/space,
/area/crawler)
"i" = (
/obj/structure/railing,
/turf/space,
/area/crawler)
"j" = (
/obj/machinery/light/floor,
/obj/structure/bed/chair/custom/onestar,
/turf/floor/tiled/derelict/white_small_edges,
/area/crawler)
"k" = (
/obj/crawler/crawler_wallbreaker/vertical,
/turf/floor/bluegrid,
/area/crawler)
"l" = (
/obj/structure/catwalk,
/turf/space,
/area/crawler)
"m" = (
/obj/structure/catwalk,
/obj/machinery/door/airlock/external,
/turf/space,
/area/crawler)
"n" = (
/obj/structure/railing{
	dir = 1
	},
/turf/space,
/area/crawler)
"o" = (
/obj/structure/railing/grey{
	dir = 4
	},
/turf/floor/tiled/dark/techfloor,
/area/crawler)
"p" = (
/obj/structure/railing/grey{
	dir = 4
	},
/obj/structure/railing/grey,
/turf/floor/plating/under,
/area/crawler)
"q" = (
/obj/structure/railing/grey{
	dir = 4
	},
/obj/structure/railing/grey{
	dir = 1
	},
/turf/floor/plating/under,
/area/crawler)
"r" = (
/turf/floor/tiled/derelict,
/area/crawler)
"u" = (
/obj/structure/bed/chair/custom/onestar,
/turf/floor/tiled/derelict/white_small_edges,
/area/crawler)
"v" = (
/obj/structure/sign/directions/evac{
	dir = 8;
	pixel_x = -32
	},
/obj/item/tank/onestar_regenerator,
/turf/floor/tiled/derelict,
/area/crawler)
"x" = (
/obj/structure/bed/chair/custom/onestar{
	dir = 1
	},
/turf/floor/tiled/derelict/white_small_edges,
/area/crawler)
"y" = (
/turf/wall/low/onestar,
/area/crawler)
"D" = (
/obj/structure/sign/directions/evac{
	dir = 8;
	pixel_x = -32
	},
/obj/structure/salvageable/os/console_broken{
	dir = 4
	},
/turf/floor/tiled/derelict,
/area/crawler)
"G" = (
/obj/structure/bed/chair/custom/onestar,
/obj/structure/sign/derelict3{
	pixel_y = 32
	},
/turf/floor/tiled/derelict/white_small_edges,
/area/crawler)
"R" = (
/obj/item/remains/human,
/turf/floor/tiled/derelict/white_small_edges,
/area/crawler)
"T" = (
/obj/spawner/toy,
/turf/floor/tiled/derelict/white_small_edges,
/area/crawler)
"Z" = (
/obj/machinery/light/floor,
/obj/structure/bed/chair/custom/onestar{
	dir = 1
	},
/turf/floor/tiled/derelict/white_small_edges,
/area/crawler)

(1,1,1) = {"
a
a
a
a
a
g
a
a
a
"}
(2,1,1) = {"
a
c
d
d
d
d
d
c
a
"}
(3,1,1) = {"
a
d
a
f
f
y
a
d
a
"}
(4,1,1) = {"
a
d
f
h
h
h
f
d
a
"}
(5,1,1) = {"
a
d
f
h
h
h
f
d
b
"}
(6,1,1) = {"
b
d
f
h
h
h
f
d
b
"}
(7,1,1) = {"
b
d
a
i
l
n
a
d
b
"}
(8,1,1) = {"
b
d
a
a
m
a
a
d
b
"}
(9,1,1) = {"
a
o
p
D
r
v
q
o
b
"}
(10,1,1) = {"
a
G
T
r
r
r
e
x
a
"}
(11,1,1) = {"
a
j
R
r
r
r
e
Z
a
"}
(12,1,1) = {"
a
u
e
r
r
r
e
x
a
"}
(13,1,1) = {"
a
a
g
k
k
k
g
a
a
"}
