"a" = (/obj/crawler/crawler_wallbreaker,/turf/simulated/wall/untinted/onestar_reinforced,/area/crawler)
"b" = (/obj/crawler/crawler_wallbreaker/vertical,/turf/simulated/wall/untinted/onestar_reinforced,/area/crawler)
"c" = (/turf/simulated/floor/tiled/derelict/white_small_edges,/area/crawler)
"d" = (/turf/simulated/wall/untinted/onestar,/area/crawler)
"e" = (/turf/simulated/wall/untinted/onestar_reinforced,/area/crawler)
"f" = (/turf/simulated/floor/tiled/techmaint,/area/crawler)
"g" = (/turf/simulated/floor/tiled/derelict,/area/crawler)
"h" = (/obj/machinery/light/floor,/turf/simulated/floor/tiled/derelict,/area/crawler)
"i" = (/obj/structure/sign/securearea,/turf/simulated/wall/untinted/onestar,/area/crawler)
"j" = (/obj/random/mob/roomba,/turf/simulated/floor/tiled/techmaint,/area/crawler)

(1,1,1) = {"
eeeeeaaaeeeee
eccccccccccce
eciccejeccdcb
bghgeefeeghgb
bgggjfffjgggb
bghgeefeeghgb
ecdccejeccicb
eccccccccccce
eeeeaaaaaeeee
"}
