"a" = (/turf/simulated/wall/untinted/onestar_reinforced,/area/crawler)
"b" = (/obj/structure/flora/ausbushes/sparsegrass,/obj/machinery/light/floor,/turf/simulated/floor/grass,/area/crawler)
"c" = (/turf/simulated/floor/tiled/derelict/white_small_edges,/area/crawler)
"d" = (/obj/structure/railing/grey,/turf/simulated/floor/tiled/derelict/white_small_edges,/area/crawler)
"e" = (/obj/structure/railing/grey,/obj/structure/railing/grey{dir = 4},/turf/simulated/floor/tiled/derelict/white_small_edges,/area/crawler)
"f" = (/obj/effect/floor_decal/grass_edge,/turf/simulated/floor/tiled/derelict,/area/crawler)
"g" = (/obj/structure/railing/grey{dir = 8},/obj/structure/railing/grey,/turf/simulated/floor/tiled/derelict/white_small_edges,/area/crawler)
"h" = (/obj/structure/railing/grey{dir = 4},/obj/structure/railing/grey,/turf/simulated/floor/tiled/derelict/white_small_edges,/area/crawler)
"i" = (/obj/structure/flora/ausbushes/leafybush,/obj/structure/flora/ausbushes/grassybush,/turf/simulated/floor/grass,/area/crawler)
"j" = (/obj/structure/flora/ausbushes/sparsegrass,/turf/simulated/floor/grass,/area/crawler)
"k" = (/obj/structure/flora/ausbushes/lavendergrass,/turf/simulated/floor/grass,/area/crawler)
"l" = (/obj/structure/flora/ausbushes/ppflowers,/turf/simulated/floor/grass,/area/crawler)
"m" = (/obj/structure/flora/ausbushes/leafybush,/turf/simulated/floor/grass,/area/crawler)
"n" = (/obj/structure/flora/ausbushes/ywflowers,/turf/simulated/floor/grass,/area/crawler)
"o" = (/obj/structure/flora/ausbushes/reedbush,/obj/structure/flora/ausbushes/fullgrass,/obj/machinery/light/floor,/turf/simulated/floor/grass,/area/crawler)
"p" = (/obj/structure/flora/ausbushes/fullgrass,/turf/simulated/floor/grass,/area/crawler)
"q" = (/obj/crawler/crawler_wallbreaker/vertical,/turf/simulated/wall/untinted/onestar_reinforced,/area/crawler)
"r" = (/obj/random/mob/roomba,/turf/simulated/floor/grass,/area/crawler)
"s" = (/obj/effect/floor_decal/grass_edge{dir = 4},/turf/simulated/floor/tiled/derelict,/area/crawler)
"t" = (/obj/structure/flora/ausbushes/ppflowers,/obj/structure/flora/ausbushes/lavendergrass,/turf/simulated/floor/grass,/area/crawler)
"u" = (/obj/structure/flora/ausbushes/lavendergrass,/obj/structure/flora/ausbushes/grassybush,/turf/simulated/floor/grass,/area/crawler)
"v" = (/obj/structure/flora/ausbushes/brflowers,/turf/simulated/floor/grass,/area/crawler)
"w" = (/obj/structure/flora/ausbushes/ppflowers,/obj/structure/flora/ausbushes/brflowers,/turf/simulated/floor/grass,/area/crawler)
"x" = (/obj/effect/floor_decal/grass_edge{dir = 8},/turf/simulated/floor/tiled/derelict,/area/crawler)
"z" = (/obj/structure/flora/ausbushes/ywflowers,/obj/structure/flora/ausbushes/leafybush,/turf/simulated/floor/grass,/area/crawler)
"A" = (/obj/structure/flora/ausbushes/lavendergrass,/obj/structure/flora/ausbushes/fullgrass,/turf/simulated/floor/grass,/area/crawler)
"B" = (/obj/structure/flora/ausbushes/brflowers,/obj/structure/flora/ausbushes/ppflowers,/turf/simulated/floor/grass,/area/crawler)
"C" = (/obj/structure/flora/ausbushes/leafybush,/obj/structure/flora/ausbushes/fullgrass,/turf/simulated/floor/grass,/area/crawler)
"D" = (/obj/structure/flora/ausbushes/grassybush,/turf/simulated/floor/grass,/area/crawler)
"E" = (/obj/structure/flora/ausbushes/brflowers,/obj/structure/flora/ausbushes/ppflowers,/obj/structure/flora/ausbushes/leafybush,/turf/simulated/floor/grass,/area/crawler)
"F" = (/obj/structure/flora/ausbushes/ppflowers,/obj/structure/flora/ausbushes/ywflowers,/turf/simulated/floor/grass,/area/crawler)
"G" = (/obj/structure/railing/grey{dir = 4},/obj/structure/railing/grey{dir = 1},/turf/simulated/floor/tiled/derelict/white_small_edges,/area/crawler)
"H" = (/obj/structure/flora/ausbushes/sparsegrass,/obj/structure/flora/ausbushes/reedbush,/turf/simulated/floor/grass,/area/crawler)
"I" = (/obj/structure/flora/ausbushes/ywflowers,/obj/structure/flora/ausbushes/reedbush,/turf/simulated/floor/grass,/area/crawler)
"J" = (/obj/structure/railing/grey{dir = 8},/obj/structure/railing/grey{dir = 1},/turf/simulated/floor/tiled/derelict/white_small_edges,/area/crawler)
"K" = (/obj/structure/railing/grey{dir = 1},/turf/simulated/floor/tiled/derelict/white_small_edges,/area/crawler)
"L" = (/obj/effect/floor_decal/grass_edge{dir = 1},/turf/simulated/floor/tiled/derelict,/area/crawler)
"M" = (/obj/crawler/crawler_wallbreaker,/turf/simulated/wall/untinted/onestar_reinforced,/area/crawler)

(1,1,1) = {"
aaaaaMMMaaaaa
acdaefffgadca
ahibkrmnjopgq
qsktulnvwppxq
qszAppBvnnCxq
qsppDlwEDFnxq
aGjrHntkrbIJq
acKaGLLLJaKca
aaaaMMMMMaaaa
"}
