//MAP CONVERTED BY dmm2tgm.py THIS HEADER COMMENT PREVENTS RECONVERSION, DO NOT REMOVE
"a" = (
/turf/wall/untinted/onestar_reinforced,
/area/crawler)
"b" = (
/obj/structure/flora/ausbushes/sparsegrass,
/obj/machinery/light/floor,
/turf/floor/grass,
/area/crawler)
"c" = (
/turf/floor/tiled/derelict/white_small_edges,
/area/crawler)
"d" = (
/obj/structure/railing/grey,
/turf/floor/tiled/derelict/white_small_edges,
/area/crawler)
"e" = (
/obj/structure/railing/grey,
/obj/structure/railing/grey{
	dir = 4
	},
/turf/floor/tiled/derelict/white_small_edges,
/area/crawler)
"f" = (
/obj/effect/floor_decal/grass_edge,
/turf/floor/tiled/derelict,
/area/crawler)
"g" = (
/obj/structure/railing/grey{
	dir = 8
	},
/obj/structure/railing/grey,
/turf/floor/tiled/derelict/white_small_edges,
/area/crawler)
"h" = (
/obj/structure/railing/grey{
	dir = 4
	},
/obj/structure/railing/grey,
/turf/floor/tiled/derelict/white_small_edges,
/area/crawler)
"i" = (
/obj/structure/flora/ausbushes/leafybush,
/obj/structure/flora/ausbushes/grassybush,
/turf/floor/grass,
/area/crawler)
"j" = (
/obj/structure/flora/ausbushes/sparsegrass,
/turf/floor/grass,
/area/crawler)
"k" = (
/obj/structure/flora/ausbushes/lavendergrass,
/turf/floor/grass,
/area/crawler)
"l" = (
/obj/structure/flora/ausbushes/ppflowers,
/turf/floor/grass,
/area/crawler)
"m" = (
/obj/structure/flora/ausbushes/leafybush,
/turf/floor/grass,
/area/crawler)
"n" = (
/obj/structure/flora/ausbushes/ywflowers,
/turf/floor/grass,
/area/crawler)
"o" = (
/obj/structure/flora/ausbushes/reedbush,
/obj/structure/flora/ausbushes/fullgrass,
/obj/machinery/light/floor,
/turf/floor/grass,
/area/crawler)
"p" = (
/obj/structure/flora/ausbushes/fullgrass,
/turf/floor/grass,
/area/crawler)
"q" = (
/obj/crawler/crawler_wallbreaker/vertical,
/turf/wall/untinted/onestar_reinforced,
/area/crawler)
"r" = (
/obj/spawner/mob/roomba,
/turf/floor/grass,
/area/crawler)
"s" = (
/obj/effect/floor_decal/grass_edge{
	dir = 4
	},
/turf/floor/tiled/derelict,
/area/crawler)
"t" = (
/obj/structure/flora/ausbushes/ppflowers,
/obj/structure/flora/ausbushes/lavendergrass,
/turf/floor/grass,
/area/crawler)
"u" = (
/obj/structure/flora/ausbushes/lavendergrass,
/obj/structure/flora/ausbushes/grassybush,
/turf/floor/grass,
/area/crawler)
"v" = (
/obj/structure/flora/ausbushes/brflowers,
/turf/floor/grass,
/area/crawler)
"w" = (
/obj/structure/flora/ausbushes/ppflowers,
/obj/structure/flora/ausbushes/brflowers,
/turf/floor/grass,
/area/crawler)
"x" = (
/obj/effect/floor_decal/grass_edge{
	dir = 8
	},
/turf/floor/tiled/derelict,
/area/crawler)
"z" = (
/obj/structure/flora/ausbushes/ywflowers,
/obj/structure/flora/ausbushes/leafybush,
/turf/floor/grass,
/area/crawler)
"A" = (
/obj/structure/flora/ausbushes/lavendergrass,
/obj/structure/flora/ausbushes/fullgrass,
/turf/floor/grass,
/area/crawler)
"B" = (
/obj/structure/flora/ausbushes/brflowers,
/obj/structure/flora/ausbushes/ppflowers,
/turf/floor/grass,
/area/crawler)
"C" = (
/obj/structure/flora/ausbushes/leafybush,
/obj/structure/flora/ausbushes/fullgrass,
/turf/floor/grass,
/area/crawler)
"D" = (
/obj/structure/flora/ausbushes/grassybush,
/turf/floor/grass,
/area/crawler)
"E" = (
/obj/structure/flora/ausbushes/brflowers,
/obj/structure/flora/ausbushes/ppflowers,
/obj/structure/flora/ausbushes/leafybush,
/turf/floor/grass,
/area/crawler)
"F" = (
/obj/structure/flora/ausbushes/ppflowers,
/obj/structure/flora/ausbushes/ywflowers,
/turf/floor/grass,
/area/crawler)
"G" = (
/obj/structure/railing/grey{
	dir = 4
	},
/obj/structure/railing/grey{
	dir = 1
	},
/turf/floor/tiled/derelict/white_small_edges,
/area/crawler)
"H" = (
/obj/structure/flora/ausbushes/sparsegrass,
/obj/structure/flora/ausbushes/reedbush,
/turf/floor/grass,
/area/crawler)
"I" = (
/obj/structure/flora/ausbushes/ywflowers,
/obj/structure/flora/ausbushes/reedbush,
/turf/floor/grass,
/area/crawler)
"J" = (
/obj/structure/railing/grey{
	dir = 8
	},
/obj/structure/railing/grey{
	dir = 1
	},
/turf/floor/tiled/derelict/white_small_edges,
/area/crawler)
"K" = (
/obj/structure/railing/grey{
	dir = 1
	},
/turf/floor/tiled/derelict/white_small_edges,
/area/crawler)
"L" = (
/obj/effect/floor_decal/grass_edge{
	dir = 1
	},
/turf/floor/tiled/derelict,
/area/crawler)
"M" = (
/obj/crawler/crawler_wallbreaker,
/turf/wall/untinted/onestar_reinforced,
/area/crawler)

(1,1,1) = {"
a
a
a
q
q
q
a
a
a
"}
(2,1,1) = {"
a
c
h
s
s
s
G
c
a
"}
(3,1,1) = {"
a
d
i
k
z
p
j
K
a
"}
(4,1,1) = {"
a
a
b
t
A
p
r
a
a
"}
(5,1,1) = {"
a
e
k
u
p
D
H
G
M
"}
(6,1,1) = {"
M
f
r
l
p
l
n
L
M
"}
(7,1,1) = {"
M
f
m
n
B
w
t
L
M
"}
(8,1,1) = {"
M
f
n
v
v
E
k
L
M
"}
(9,1,1) = {"
a
g
j
w
n
D
r
J
M
"}
(10,1,1) = {"
a
a
o
p
n
F
b
a
a
"}
(11,1,1) = {"
a
d
p
p
C
n
I
K
a
"}
(12,1,1) = {"
a
c
g
x
x
x
J
c
a
"}
(13,1,1) = {"
a
a
q
q
q
q
q
a
a
"}
