//MAP CONVERTED BY dmm2tgm.py THIS HEADER COMMENT PREVENTS RECONVERSION, DO NOT REMOVE
"a" = (
/turf/wall/untinted/onestar_reinforced,
/area/crawler)
"b" = (
/obj/crawler/crawler_wallbreaker,
/turf/wall/untinted/onestar_reinforced,
/area/crawler)
"c" = (
/obj/structure/grille,
/turf/floor/tiled/techmaint,
/area/crawler)
"d" = (
/obj/machinery/atmospherics/pipe/simple/hidden/yellow,
/obj/structure/lattice,
/turf/floor/plating/under,
/area/crawler)
"e" = (
/obj/structure/grille,
/turf/floor/tiled/techmaint_panels,
/area/crawler)
"f" = (
/obj/machinery/atmospherics/pipe/simple/hidden/red,
/obj/structure/lattice,
/turf/floor/plating/under,
/area/crawler)
"g" = (
/obj/machinery/atmospherics/pipe/simple/hidden/blue,
/obj/structure/lattice,
/turf/floor/plating/under,
/area/crawler)
"h" = (
/obj/structure/railing/grey,
/turf/floor/tiled/techmaint,
/area/crawler)
"i" = (
/obj/structure/railing/grey,
/obj/machinery/atmospherics/pipe/simple/hidden/yellow,
/turf/floor/plating/under,
/area/crawler)
"j" = (
/obj/structure/railing/grey,
/obj/machinery/atmospherics/pipe/simple/hidden/red,
/turf/floor/plating/under,
/area/crawler)
"k" = (
/obj/structure/railing/grey,
/obj/machinery/atmospherics/pipe/simple/hidden/blue,
/turf/floor/plating/under,
/area/crawler)
"l" = (
/obj/crawler/crawler_wallbreaker/vertical,
/turf/wall/untinted/onestar_reinforced,
/area/crawler)
"m" = (
/obj/machinery/atmospherics/pipe/simple/hidden/blue{
	dir = 4
	},
/obj/structure/catwalk,
/turf/floor/plating/under,
/area/crawler)
"n" = (
/obj/machinery/atmospherics/pipe/simple/hidden/blue{
	dir = 4
	},
/obj/machinery/atmospherics/pipe/simple/hidden/yellow,
/obj/structure/catwalk,
/turf/floor/plating/under,
/area/crawler)
"o" = (
/obj/machinery/atmospherics/pipe/simple/hidden/blue{
	dir = 4
	},
/obj/structure/catwalk,
/obj/machinery/light/floor,
/turf/floor/plating/under,
/area/crawler)
"p" = (
/obj/machinery/atmospherics/pipe/simple/hidden/red,
/obj/machinery/atmospherics/pipe/simple/hidden/blue{
	dir = 4
	},
/obj/structure/catwalk,
/turf/floor/plating/under,
/area/crawler)
"q" = (
/obj/machinery/atmospherics/pipe/manifold/hidden/blue,
/obj/structure/catwalk,
/turf/floor/plating/under,
/area/crawler)
"r" = (
/obj/machinery/atmospherics/pipe/manifold/hidden/blue{
	dir = 4
	},
/obj/structure/catwalk,
/turf/floor/plating/under,
/area/crawler)
"s" = (
/obj/structure/catwalk,
/obj/machinery/light/floor,
/turf/floor/plating/under,
/area/crawler)
"t" = (
/obj/machinery/atmospherics/pipe/simple/hidden/yellow,
/obj/structure/catwalk,
/turf/floor/plating/under,
/area/crawler)
"u" = (
/obj/structure/catwalk,
/turf/floor/plating/under,
/area/crawler)
"v" = (
/obj/machinery/atmospherics/pipe/manifold/hidden/yellow{
	dir = 8
	},
/obj/structure/catwalk,
/turf/floor/plating/under,
/area/crawler)
"w" = (
/obj/machinery/atmospherics/pipe/simple/hidden/yellow{
	dir = 4
	},
/obj/structure/catwalk,
/turf/floor/plating/under,
/area/crawler)
"x" = (
/obj/machinery/atmospherics/pipe/simple/hidden/red,
/obj/machinery/atmospherics/pipe/simple/hidden/yellow{
	dir = 4
	},
/obj/structure/catwalk,
/turf/floor/plating/under,
/area/crawler)
"y" = (
/obj/machinery/atmospherics/pipe/simple/hidden/blue,
/obj/machinery/atmospherics/pipe/simple/hidden/yellow{
	dir = 4
	},
/obj/structure/catwalk,
/turf/floor/plating/under,
/area/crawler)
"z" = (
/obj/machinery/atmospherics/pipe/simple/hidden/yellow{
	dir = 4
	},
/obj/structure/catwalk,
/obj/spawner/mob/roomba,
/turf/floor/plating/under,
/area/crawler)
"A" = (
/obj/machinery/atmospherics/pipe/simple/hidden/red{
	dir = 4
	},
/obj/structure/catwalk,
/obj/machinery/light/floor,
/turf/floor/plating/under,
/area/crawler)
"B" = (
/obj/machinery/atmospherics/pipe/manifold/hidden/red{
	dir = 8
	},
/obj/structure/catwalk,
/turf/floor/plating/under,
/area/crawler)
"C" = (
/obj/machinery/atmospherics/pipe/manifold/hidden/red{
	dir = 1
	},
/obj/structure/catwalk,
/turf/floor/plating/under,
/area/crawler)
"D" = (
/obj/machinery/atmospherics/pipe/simple/hidden/red{
	dir = 4
	},
/obj/machinery/atmospherics/pipe/simple/hidden/blue,
/obj/structure/catwalk,
/turf/floor/plating/under,
/area/crawler)
"E" = (
/obj/machinery/atmospherics/pipe/manifold4w/hidden/yellow,
/obj/structure/catwalk,
/obj/spawner/mob/roomba,
/turf/floor/plating/under,
/area/crawler)
"F" = (
/obj/machinery/atmospherics/pipe/simple/hidden/red{
	dir = 4
	},
/obj/machinery/atmospherics/pipe/simple/hidden/yellow,
/obj/structure/catwalk,
/turf/floor/plating/under,
/area/crawler)
"G" = (
/obj/machinery/atmospherics/pipe/simple/hidden/red{
	dir = 4
	},
/obj/structure/catwalk,
/turf/floor/plating/under,
/area/crawler)
"H" = (
/obj/structure/railing/grey{
	dir = 1
	},
/turf/floor/tiled/techmaint,
/area/crawler)
"I" = (
/obj/structure/railing/grey{
	dir = 1
	},
/obj/machinery/atmospherics/pipe/simple/hidden/yellow,
/turf/floor/plating/under,
/area/crawler)
"J" = (
/obj/structure/railing/grey{
	dir = 1
	},
/obj/machinery/atmospherics/pipe/simple/hidden/red,
/turf/floor/plating/under,
/area/crawler)
"K" = (
/obj/structure/railing/grey{
	dir = 1
	},
/obj/machinery/atmospherics/pipe/simple/hidden/blue,
/turf/floor/plating/under,
/area/crawler)

(1,1,1) = {"
a
a
a
l
l
l
a
a
a
"}
(2,1,1) = {"
a
c
h
m
u
u
H
c
a
"}
(3,1,1) = {"
a
c
h
m
u
u
H
c
a
"}
(4,1,1) = {"
a
d
i
n
v
t
I
d
a
"}
(5,1,1) = {"
a
e
a
o
z
s
a
e
b
"}
(6,1,1) = {"
b
f
j
p
x
B
J
f
b
"}
(7,1,1) = {"
b
g
k
q
w
C
J
f
b
"}
(8,1,1) = {"
b
g
k
r
y
D
K
g
b
"}
(9,1,1) = {"
a
e
a
s
w
A
a
e
b
"}
(10,1,1) = {"
a
d
i
t
E
F
I
d
a
"}
(11,1,1) = {"
a
c
h
u
w
G
H
c
a
"}
(12,1,1) = {"
a
c
h
u
w
G
H
c
a
"}
(13,1,1) = {"
a
a
l
l
l
l
l
a
a
"}
