//MAP CONVERTED BY dmm2tgm.py THIS HEADER COMMENT PREVENTS RECONVERSION, DO NOT REMOVE
"a" = (
/turf/wall/untinted/onestar_reinforced,
/area/crawler)
"b" = (
/obj/structure/noticeboard,
/turf/wall/untinted/onestar_reinforced,
/area/crawler)
"c" = (
/obj/structure/bed/chair/office/dark{
	dir = 1
	},
/obj/machinery/light/floor,
/turf/floor/wood,
/area/crawler)
"d" = (
/turf/floor/wood,
/area/crawler)
"e" = (
/obj/structure/bed/chair/office/dark,
/turf/floor/wood,
/area/crawler)
"f" = (
/obj/structure/window/reinforced{
	dir = 4;
	id = 10
	},
/turf/floor/wood,
/area/crawler)
"g" = (
/turf/floor/tiled/derelict,
/area/crawler)
"h" = (
/obj/structure/window/reinforced{
	dir = 8;
	id = 11
	},
/turf/floor/wood,
/area/crawler)
"i" = (
/obj/structure/bed/chair/office/dark,
/obj/machinery/light/floor,
/turf/floor/wood,
/area/crawler)
"j" = (
/obj/structure/table/onestar,
/turf/floor/tiled/techmaint,
/area/crawler)
"k" = (
/obj/structure/table/onestar,
/turf/floor/wood,
/area/crawler)
"l" = (
/obj/machinery/light/floor,
/turf/floor/wood,
/area/crawler)
"m" = (
/obj/crawler/crawler_wallbreaker/vertical,
/turf/wall/untinted/onestar_reinforced,
/area/crawler)
"n" = (
/obj/structure/bed/chair/office/dark{
	dir = 4
	},
/turf/floor/wood,
/area/crawler)
"o" = (
/obj/effect/floor_decal/plaque{
	desc = a plauque with an insignia you cant make out and text in chineese.
	},
/turf/floor/tiled/derelict,
/area/crawler)
"p" = (
/obj/structure/bed/chair/office/dark{
	dir = 8
	},
/turf/floor/wood,
/area/crawler)
"q" = (
/obj/structure/window/reinforced{
	dir = 4;
	id = 10
	},
/obj/structure/window/reinforced{
	id = 10
	},
/turf/floor/wood,
/area/crawler)
"r" = (
/obj/structure/window/reinforced{
	dir = 8;
	id = 11
	},
/obj/structure/window/reinforced{
	id = 11
	},
/obj/item/storage/briefcase{
	pixel_x = 6
	},
/turf/floor/wood,
/area/crawler)
"s" = (
/obj/structure/window/reinforced{
	dir = 4;
	id = 10
	},
/obj/structure/sign/faction/one_star{
	pixel_y = 32
	},
/turf/floor/wood,
/area/crawler)
"t" = (
/obj/spawner/mob/roomba,
/turf/floor/tiled/derelict,
/area/crawler)
"u" = (
/obj/structure/window/reinforced{
	dir = 4;
	id = 10
	},
/turf/floor/tiled/derelict/white_small_edges,
/area/crawler)
"v" = (
/obj/structure/window/reinforced{
	dir = 8;
	id = 11
	},
/turf/floor/tiled/derelict/white_small_edges,
/area/crawler)
"w" = (
/obj/structure/closet/onestar/tier1,
/turf/floor/wood,
/area/crawler)
"x" = (
/obj/structure/table/rack,
/obj/spawner/cloth/onestar/low_chance,
/turf/floor/wood,
/area/crawler)
"y" = (
/obj/structure/window/reinforced{
	dir = 4;
	id = 10
	},
/obj/structure/table/onestar,
/obj/machinery/button/switch{
	id = 10
	},
/turf/floor/wood,
/area/crawler)
"z" = (
/turf/floor/tiled/derelict/white_small_edges,
/area/crawler)
"A" = (
/obj/structure/window/reinforced{
	dir = 8;
	id = 11
	},
/obj/structure/table/onestar,
/obj/machinery/button/switch{
	id = 11
	},
/turf/floor/wood,
/area/crawler)
"B" = (
/obj/crawler/crawler_wallbreaker,
/turf/wall/untinted/onestar_reinforced,
/area/crawler)
"C" = (
/obj/structure/closet/onestar/tier2,
/turf/floor/wood,
/area/crawler)
"K" = (
/obj/structure/table/rack,
/obj/structure/sign/faction/one_star{
	pixel_y = -32
	},
/obj/spawner/contraband/low_chance,
/obj/spawner/lathe_disk/advanced/low_chance,
/turf/floor/wood,
/area/crawler)
"L" = (
/obj/structure/table/onestar,
/obj/spawner/gun/onestar/low_chance,
/turf/floor/wood,
/area/crawler)
"N" = (
/obj/structure/table/onestar,
/obj/item/oddity/common/old_newspaper,
/turf/floor/tiled/techmaint,
/area/crawler)
"Q" = (
/obj/structure/table/rack,
/obj/structure/sign/faction/one_star{
	pixel_y = -32
	},
/obj/spawner/science/low_chance,
/turf/floor/wood,
/area/crawler)
"X" = (
/obj/structure/window/reinforced{
	dir = 8;
	id = 11
	},
/obj/structure/sign/faction/one_star{
	pixel_y = 32
	},
/turf/floor/wood,
/area/crawler)

(1,1,1) = {"
a
a
a
a
a
m
a
a
a
"}
(2,1,1) = {"
a
d
c
n
e
d
l
x
a
"}
(3,1,1) = {"
b
e
j
j
j
d
d
K
a
"}
(4,1,1) = {"
a
n
j
j
N
p
d
y
a
"}
(5,1,1) = {"
a
s
f
f
f
q
u
z
B
"}
(6,1,1) = {"
B
g
g
g
g
g
t
g
B
"}
(7,1,1) = {"
B
g
t
g
o
g
g
g
B
"}
(8,1,1) = {"
B
g
g
g
g
g
g
t
B
"}
(9,1,1) = {"
a
X
h
h
h
r
v
z
B
"}
(10,1,1) = {"
a
e
k
k
k
e
d
A
a
"}
(11,1,1) = {"
a
e
L
k
k
n
d
Q
a
"}
(12,1,1) = {"
a
w
i
d
p
d
l
C
a
"}
(13,1,1) = {"
a
a
m
m
m
m
m
a
a
"}
