//MAP CONVERTED BY dmm2tgm.py THIS HEADER COMMENT PREVENTS RECONVERSION, DO NOT REMOVE
"a" = (
/turf/wall/untinted/onestar_reinforced,
/area/crawler)
"b" = (
/obj/structure/extinguisher_cabinet,
/turf/wall/untinted/onestar_reinforced,
/area/crawler)
"c" = (
/obj/machinery/light/floor,
/turf/floor/tiled/dark/techfloor_grid,
/area/crawler)
"d" = (
/obj/machinery/antigrav,
/turf/floor/bluegrid,
/area/crawler)
"e" = (
/obj/spawner/pack/tech_loot/onestar,
/turf/floor/bluegrid,
/area/crawler)
"f" = (
/obj/structure/window/reinforced{
	dir = 4
	},
/turf/floor/tiled/dark/techfloor,
/area/crawler)
"g" = (
/obj/effect/floor_decal/industrial/warning/corner{
	dir = 8
	},
/turf/floor/tiled/derelict,
/area/crawler)
"h" = (
/turf/floor/tiled/derelict,
/area/crawler)
"i" = (
/obj/effect/floor_decal/industrial/warning/corner,
/turf/floor/tiled/derelict,
/area/crawler)
"j" = (
/obj/structure/window/reinforced{
	dir = 8
	},
/turf/floor/tiled/dark/techfloor,
/area/crawler)
"k" = (
/obj/machinery/r_n_d/server,
/turf/floor/bluegrid,
/area/crawler)
"l" = (
/obj/structure/salvageable/os/console,
/turf/floor/bluegrid,
/area/crawler)
"m" = (
/obj/machinery/light/floor,
/turf/floor/tiled/derelict,
/area/crawler)
"n" = (
/turf/floor/tiled/dark/techfloor_grid,
/area/crawler)
"o" = (
/obj/machinery/door/window/eastright,
/turf/floor/tiled/dark/techfloor,
/area/crawler)
"p" = (
/obj/effect/floor_decal/industrial/warning{
	dir = 8
	},
/turf/floor/tiled/derelict,
/area/crawler)
"q" = (
/obj/effect/floor_decal/industrial/warning{
	dir = 4
	},
/turf/floor/tiled/derelict,
/area/crawler)
"r" = (
/obj/machinery/door/window/westright,
/turf/floor/tiled/dark/techfloor,
/area/crawler)
"s" = (
/obj/spawner/mob/roomba,
/turf/floor/tiled/derelict,
/area/crawler)
"t" = (
/obj/crawler/crawler_wallbreaker/vertical,
/turf/wall/untinted/onestar_reinforced,
/area/crawler)
"u" = (
/obj/machinery/shieldwallgen/excelsior,
/turf/floor/bluegrid,
/area/crawler)
"v" = (
/obj/effect/floor_decal/industrial/warning/corner{
	dir = 1
	},
/turf/floor/tiled/derelict,
/area/crawler)
"w" = (
/obj/effect/floor_decal/industrial/warning/corner{
	dir = 4;
	icon_state = "warningcorner"
	},
/turf/floor/tiled/derelict,
/area/crawler)
"x" = (
/obj/machinery/constructable_frame/machine_frame/vertical,
/turf/floor/bluegrid,
/area/crawler)
"y" = (
/obj/spawner/toy/plushie,
/turf/floor/bluegrid,
/area/crawler)
"z" = (
/obj/structure/table/rack,
/obj/spawner/tool/advanced/onestar/low_chance,
/obj/spawner/tool_upgrade/rare/onestar,
/turf/floor/bluegrid,
/area/crawler)
"A" = (
/obj/structure/closet/onestar/tier2,
/turf/floor/bluegrid,
/area/crawler)
"B" = (
/obj/structure/closet/onestar/tier3,
/turf/floor/bluegrid,
/area/crawler)
"C" = (
/obj/machinery/power/port_gen/os_generator,
/turf/floor/bluegrid,
/area/crawler)
"D" = (
/obj/structure/window/reinforced{
	dir = 4
	},
/obj/spawner/toolbox,
/turf/floor/tiled/dark/techfloor,
/area/crawler)
"E" = (
/obj/structure/salvageable/os/implant_container,
/turf/floor/bluegrid,
/area/crawler)
"F" = (
/obj/structure/salvageable/os/server,
/turf/floor/bluegrid,
/area/crawler)
"G" = (
/obj/structure/salvageable/os/machine,
/turf/floor/bluegrid,
/area/crawler)
"H" = (
/obj/structure/salvageable/os/computer,
/turf/floor/bluegrid,
/area/crawler)
"I" = (
/obj/structure/salvageable/os/data,
/turf/floor/bluegrid,
/area/crawler)
"J" = (
/obj/crawler/crawler_wallbreaker,
/turf/wall/untinted/onestar_reinforced,
/area/crawler)
"T" = (
/obj/structure/salvageable/os/console_broken{
	dir = 1
	},
/turf/floor/bluegrid,
/area/crawler)
"Z" = (
/obj/structure/salvageable/bliss,
/turf/floor/bluegrid,
/area/crawler)

(1,1,1) = {"
a
a
a
a
a
t
a
a
a
"}
(2,1,1) = {"
a
d
c
e
a
B
c
G
a
"}
(3,1,1) = {"
a
A
n
u
a
Z
n
H
a
"}
(4,1,1) = {"
a
A
n
u
a
C
n
F
a
"}
(5,1,1) = {"
b
f
o
f
b
D
o
f
J
"}
(6,1,1) = {"
J
g
p
v
m
g
p
v
J
"}
(7,1,1) = {"
J
h
s
h
s
s
h
h
J
"}
(8,1,1) = {"
J
i
q
w
m
i
q
w
J
"}
(9,1,1) = {"
b
j
r
j
a
j
r
j
J
"}
(10,1,1) = {"
a
k
n
x
a
E
n
F
a
"}
(11,1,1) = {"
a
l
n
y
a
F
n
T
a
"}
(12,1,1) = {"
a
k
c
z
a
E
c
I
a
"}
(13,1,1) = {"
a
a
t
t
t
t
t
a
a
"}
