"a" = (/turf/simulated/wall/untinted/onestar_reinforced,/area/crawler)
"b" = (/obj/machinery/light/floor,/turf/simulated/floor/tiled/derelict,/area/crawler)
"c" = (/turf/simulated/floor/grass,/area/crawler)
"d" = (/obj/structure/railing/grey{dir = 4},/turf/simulated/floor/tiled/derelict/white_small_edges,/area/crawler)
"e" = (/turf/simulated/floor/tiled/derelict,/area/crawler)
"f" = (/obj/structure/railing/grey{dir = 8},/turf/simulated/floor/tiled/derelict/white_small_edges,/area/crawler)
"g" = (/obj/structure/railing/grey,/turf/simulated/floor/tiled/derelict/white_small_edges,/area/crawler)
"h" = (/obj/random/mob/roomba,/turf/simulated/floor/tiled/derelict,/area/crawler)
"j" = (/obj/crawler/crawler_wallbreaker/vertical,/turf/simulated/wall/untinted/onestar_reinforced,/area/crawler)
"o" = (/obj/structure/railing/grey{dir = 1},/turf/simulated/floor/tiled/derelict/white_small_edges,/area/crawler)
"p" = (/obj/crawler/crawler_wallbreaker,/turf/simulated/wall/untinted/onestar_reinforced,/area/crawler)

(1,1,1) = {"
aaaaapppaaaaa
acccdeeefccca
agggabebagggj
jeeebeeebeeej
jeeheheeeehej
jeeebeeebeeej
aoooabebaoooj
acccdeeefccca
aaaapppppaaaa
"}
