"a" = (/turf/simulated/wall/untinted/onestar_reinforced,/area/crawler)
"b" = (/obj/structure/extinguisher_cabinet,/turf/simulated/wall/untinted/onestar_reinforced,/area/crawler)
"c" = (/obj/machinery/light/floor,/turf/simulated/floor/tiled/dark/techfloor_grid,/area/crawler)
"d" = (/obj/machinery/antigrav,/turf/simulated/floor/bluegrid,/area/crawler)
"e" = (/turf/simulated/floor/bluegrid,/area/crawler)
"f" = (/obj/structure/window/reinforced{dir = 4},/turf/simulated/floor/tiled/dark/techfloor,/area/crawler)
"g" = (/obj/effect/floor_decal/industrial/warning/corner{dir = 8},/turf/simulated/floor/tiled/derelict,/area/crawler)
"h" = (/turf/simulated/floor/tiled/derelict,/area/crawler)
"i" = (/obj/effect/floor_decal/industrial/warning/corner,/turf/simulated/floor/tiled/derelict,/area/crawler)
"j" = (/obj/structure/window/reinforced{dir = 8},/turf/simulated/floor/tiled/dark/techfloor,/area/crawler)
"k" = (/obj/machinery/r_n_d/server,/turf/simulated/floor/bluegrid,/area/crawler)
"l" = (/obj/machinery/computer,/turf/simulated/floor/bluegrid,/area/crawler)
"m" = (/obj/machinery/light/floor,/turf/simulated/floor/tiled/derelict,/area/crawler)
"n" = (/turf/simulated/floor/tiled/dark/techfloor_grid,/area/crawler)
"o" = (/obj/machinery/door/window/eastright,/turf/simulated/floor/tiled/dark/techfloor,/area/crawler)
"p" = (/obj/effect/floor_decal/industrial/warning{dir = 8},/turf/simulated/floor/tiled/derelict,/area/crawler)
"q" = (/obj/effect/floor_decal/industrial/warning{dir = 4},/turf/simulated/floor/tiled/derelict,/area/crawler)
"r" = (/obj/machinery/door/window/westright,/turf/simulated/floor/tiled/dark/techfloor,/area/crawler)
"s" = (/obj/random/mob/roomba,/turf/simulated/floor/tiled/derelict,/area/crawler)
"t" = (/obj/crawler/crawler_wallbreaker/vertical,/turf/simulated/wall/untinted/onestar_reinforced,/area/crawler)
"u" = (/obj/machinery/field_generator,/turf/simulated/floor/bluegrid,/area/crawler)
"v" = (/obj/effect/floor_decal/industrial/warning/corner{dir = 1},/turf/simulated/floor/tiled/derelict,/area/crawler)
"w" = (/obj/effect/floor_decal/industrial/warning/corner{icon_state = "warningcorner"; dir = 4},/turf/simulated/floor/tiled/derelict,/area/crawler)
"x" = (/obj/machinery/constructable_frame/machine_frame/vertical,/turf/simulated/floor/bluegrid,/area/crawler)
"y" = (/obj/random/plushie,/turf/simulated/floor/bluegrid,/area/crawler)
"z" = (/obj/structure/table/rack,/turf/simulated/floor/bluegrid,/area/crawler)
"A" = (/obj/structure/closet/onestar/tier2,/turf/simulated/floor/bluegrid,/area/crawler)
"B" = (/obj/structure/closet/onestar/tier3,/turf/simulated/floor/bluegrid,/area/crawler)
"C" = (/obj/machinery/constructable_frame/machine_frame,/turf/simulated/floor/bluegrid,/area/crawler)
"D" = (/obj/structure/window/reinforced{dir = 4},/obj/random/toolbox,/turf/simulated/floor/tiled/dark/techfloor,/area/crawler)
"E" = (/obj/structure/salvageable/implant_container,/turf/simulated/floor/bluegrid,/area/crawler)
"F" = (/obj/structure/salvageable/server,/turf/simulated/floor/bluegrid,/area/crawler)
"G" = (/obj/structure/salvageable/machine,/turf/simulated/floor/bluegrid,/area/crawler)
"H" = (/obj/structure/salvageable/computer,/turf/simulated/floor/bluegrid,/area/crawler)
"I" = (/obj/structure/salvageable/data,/turf/simulated/floor/bluegrid,/area/crawler)
"J" = (/obj/crawler/crawler_wallbreaker,/turf/simulated/wall/untinted/onestar_reinforced,/area/crawler)

(1,1,1) = {"
aaaabJJJbaaaa
adAAfghijklka
acnnopsqrnnct
aeuufvhwjxyzt
aaaabmsmaaaat
tBeCDgsijEFEt
acnnophqrnnct
aGHFfvhwjGHIa
aaaaJJJJJaaaa
"}
