//MAP CONVERTED BY dmm2tgm.py THIS HEADER COMMENT PREVENTS RECONVERSION, DO NOT REMOVE
"a" = (
/turf/simulated/wall/untinted/onestar_reinforced,
/area/crawler)
"b" = (
/obj/crawler/crawler_wallbreaker,
/turf/simulated/wall/untinted/onestar_reinforced,
/area/crawler)
"c" = (
/obj/machinery/conveyor/northeast{
	id = 3
	},
/turf/simulated/floor/tiled/derelict/white_small_edges,
/area/crawler)
"d" = (
/obj/machinery/conveyor/east{
	id = 3
	},
/turf/simulated/floor/tiled/derelict,
/area/crawler)
"e" = (
/obj/effect/floor_decal/industrial/outline/yellow,
/turf/simulated/floor/tiled/derelict,
/area/crawler)
"f" = (
/obj/crawler/crawler_wallbreaker/vertical,
/turf/simulated/wall/untinted/onestar_reinforced,
/area/crawler)
"g" = (
/obj/structure/closet/onestar/tier3,
/turf/simulated/floor/tiled/derelict,
/area/crawler)
"h" = (
/obj/effect/floor_decal/rust,
/obj/effect/decal/cleanable/liquid_fuel,
/obj/machinery/light/floor,
/turf/simulated/floor/tiled/derelict/white_small_edges,
/area/crawler)
"i" = (
/obj/structure/table/onestar,
/turf/simulated/floor/tiled/derelict,
/area/crawler)
"j" = (
/obj/structure/table/onestar,
/turf/simulated/floor/tiled/dark/panels,
/area/crawler)
"k" = (
/turf/simulated/floor/tiled/dark/panels,
/area/crawler)
"l" = (
/obj/machinery/conveyor/north{
	id = 3
	},
/obj/machinery/light/floor,
/turf/simulated/floor/tiled/derelict,
/area/crawler)
"m" = (
/obj/structure/low_wall,
/obj/effect/window_lwall_spawn,
/turf/simulated/floor/tiled/techmaint,
/area/crawler)
"n" = (
/obj/structure/table/onestar,
/obj/machinery/light/floor,
/turf/simulated/floor/tiled/derelict,
/area/crawler)
"o" = (
/obj/structure/railing/grey{
	dir = 8
	},
/obj/structure/railing/grey{
	dir = 1
	},
/obj/item/storage/toolbox/mechanical,
/obj/structure/table/rack,
/turf/simulated/floor/tiled/derelict/white_small_edges,
/area/crawler)
"p" = (
/obj/effect/floor_decal/rust,
/obj/effect/decal/cleanable/liquid_fuel,
/obj/structure/closet/onestar/tier3,
/turf/simulated/floor/tiled/dark/panels,
/area/crawler)
"q" = (
/turf/simulated/floor/tiled/derelict/white_small_edges,
/area/crawler)
"r" = (
/obj/machinery/mech_recharger,
/turf/simulated/floor/tiled/derelict/white_small_edges,
/area/crawler)
"s" = (
/obj/structure/reagent_dispensers/fueltank/huge,
/obj/effect/floor_decal/industrial/outline/yellow,
/obj/effect/floor_decal/rust,
/obj/effect/decal/cleanable/liquid_fuel,
/turf/simulated/floor/tiled/dark/panels,
/area/crawler)
"t" = (
/obj/effect/floor_decal/rust,
/obj/effect/decal/cleanable/liquid_fuel,
/turf/simulated/floor/tiled/derelict/white_small_edges,
/area/crawler)
"u" = (
/obj/machinery/conveyor/north{
	id = 3
	},
/turf/simulated/floor/tiled/derelict,
/area/crawler)
"v" = (
/obj/structure/railing/grey{
	dir = 8
	},
/obj/machinery/conveyor_switch/oneway{
	id = 3
	},
/turf/simulated/floor/tiled/derelict/white_small_edges,
/area/crawler)
"w" = (
/obj/effect/floor_decal/industrial/outline/yellow,
/obj/effect/floor_decal/rust,
/obj/effect/decal/cleanable/liquid_fuel,
/turf/simulated/floor/tiled/dark/panels,
/area/crawler)
"x" = (
/obj/effect/floor_decal/industrial/warning{
	dir = 1
	},
/obj/machinery/light/floor,
/turf/simulated/floor/tiled/derelict,
/area/crawler)
"y" = (
/obj/machinery/light/floor,
/turf/simulated/floor/tiled/derelict,
/area/crawler)
"z" = (
/obj/effect/floor_decal/industrial/warning{
	dir = 1
	},
/turf/simulated/floor/tiled/derelict,
/area/crawler)
"A" = (
/obj/effect/floor_decal/industrial/loading,
/turf/simulated/floor/tiled/derelict,
/area/crawler)
"B" = (
/obj/structure/largecrate,
/obj/effect/floor_decal/industrial/loading{
	dir = 1
	},
/turf/simulated/floor/tiled/derelict,
/area/crawler)
"C" = (
/turf/simulated/floor/tiled/derelict,
/area/crawler)
"D" = (
/obj/machinery/conveyor/north{
	id = 4
	},
/turf/simulated/floor/tiled/derelict,
/area/crawler)
"E" = (
/obj/machinery/door/airlock/centcom,
/turf/simulated/floor/tiled/techmaint,
/area/crawler)
"F" = (
/obj/structure/railing/grey{
	dir = 8
	},
/obj/machinery/conveyor_switch/oneway{
	id = 4
	},
/turf/simulated/floor/tiled/derelict/white_small_edges,
/area/crawler)
"G" = (
/obj/effect/floor_decal/industrial/warning,
/obj/machinery/light/floor,
/turf/simulated/floor/tiled/derelict,
/area/crawler)
"H" = (
/obj/machinery/conveyor/north{
	id = 4
	},
/obj/machinery/light/floor,
/turf/simulated/floor/tiled/derelict,
/area/crawler)
"I" = (
/obj/effect/floor_decal/industrial/loading{
	dir = 1
	},
/turf/simulated/floor/tiled/derelict,
/area/crawler)
"J" = (
/obj/effect/floor_decal/industrial/warning,
/turf/simulated/floor/tiled/derelict,
/area/crawler)
"K" = (
/obj/machinery/light/floor,
/turf/simulated/floor/tiled/derelict/white_small_edges,
/area/crawler)
"L" = (
/obj/machinery/autolathe/mechfab,
/turf/simulated/floor/tiled/derelict/white_small_edges,
/area/crawler)
"M" = (
/obj/effect/floor_decal/industrial/hatch/yellow,
/turf/simulated/floor/tiled/dark/panels,
/area/crawler)
"N" = (
/obj/machinery/conveyor/northwest{
	id = 4
	},
/turf/simulated/floor/tiled/derelict,
/area/crawler)
"O" = (
/obj/machinery/conveyor/west{
	id = 4
	},
/turf/simulated/floor/tiled/derelict,
/area/crawler)
"P" = (
/obj/effect/floor_decal/industrial/loading{
	dir = 8
	},
/turf/simulated/floor/tiled/derelict,
/area/crawler)
"Q" = (
/obj/spawner/mob/roomba,
/turf/simulated/floor/tiled/derelict/white_small_edges,
/area/crawler)
"R" = (
/obj/effect/floor_decal/industrial/hatch/yellow,
/obj/item/storage/toolbox/electrical,
/turf/simulated/floor/tiled/dark/panels,
/area/crawler)
"S" = (
/obj/spawner/mob/roomba,
/turf/simulated/floor/tiled/derelict,
/area/crawler)

(1,1,1) = {"
a
a
a
a
a
f
a
a
a
"}
(2,1,1) = {"
a
c
l
u
B
D
H
N
a
"}
(3,1,1) = {"
a
d
o
v
C
F
L
O
a
"}
(4,1,1) = {"
a
e
Q
q
S
q
Q
P
a
"}
(5,1,1) = {"
a
g
q
q
C
q
q
i
b
"}
(6,1,1) = {"
b
i
i
n
C
y
i
i
b
"}
(7,1,1) = {"
b
m
m
a
E
a
m
m
b
"}
(8,1,1) = {"
b
j
j
x
C
G
M
M
b
"}
(9,1,1) = {"
a
k
q
z
S
I
r
k
b
"}
(10,1,1) = {"
a
h
r
A
C
J
q
K
a
"}
(11,1,1) = {"
a
p
t
z
S
I
r
k
a
"}
(12,1,1) = {"
a
s
w
z
C
J
M
R
a
"}
(13,1,1) = {"
a
a
f
f
f
f
f
a
a
"}
