//MAP CONVERTED BY dmm2tgm.py THIS HEADER COMMENT PREVENTS RECONVERSION, DO NOT REMOVE
"a" = (
/turf/wall/untinted/onestar_reinforced,
/area/crawler)
"b" = (
/obj/crawler/crawler_wallbreaker,
/turf/wall/untinted/onestar_reinforced,
/area/crawler)
"c" = (
/obj/structure/railing/grey{
	dir = 4
	},
/turf/floor/plating/under,
/area/crawler)
"d" = (
/obj/structure/catwalk,
/turf/floor/plating/under,
/area/crawler)
"e" = (
/obj/machinery/door/airlock/sandstone{
	name = "OneStar Airlock"
	},
/turf/floor/tiled/derelict/red_white_edges,
/area/crawler)
"f" = (
/turf/floor/tiled/dark/brown_perforated,
/area/crawler)
"g" = (
/turf/floor/tiled/dark/brown_platform,
/area/crawler)
"h" = (
/obj/machinery/light/floor,
/turf/floor/tiled/dark/brown_platform,
/area/crawler)
"i" = (
/obj/structure/table/onestar,
/obj/spawner/gun/energy_cheap/low_chance,
/obj/spawner/cloth/onestar/low_chance,
/turf/floor/tiled/dark/brown_perforated,
/area/crawler)
"j" = (
/turf/floor/plating/under,
/area/crawler)
"k" = (
/obj/structure/railing/grey,
/obj/structure/railing/grey{
	dir = 4
	},
/turf/floor/plating/under,
/area/crawler)
"l" = (
/obj/structure/salvageable/os/computer{
	dir = 4
	},
/turf/floor/tiled/dark/brown_perforated,
/area/crawler)
"m" = (
/obj/structure/bed/chair/custom/onestar/red,
/turf/floor/tiled/dark/brown_platform,
/area/crawler)
"n" = (
/obj/structure/railing/grey,
/turf/floor/plating/under,
/area/crawler)
"o" = (
/obj/crawler/crawler_wallbreaker/vertical,
/turf/wall/untinted/onestar_reinforced,
/area/crawler)
"p" = (
/obj/machinery/light/floor,
/turf/floor/tiled/derelict,
/area/crawler)
"q" = (
/obj/effect/floor_decal/industrial/warning{
	dir = 4
	},
/turf/floor/tiled/derelict,
/area/crawler)
"r" = (
/obj/structure/catwalk,
/turf/floor/tiled/derelict,
/area/crawler)
"s" = (
/obj/structure/sign/faction/one_star,
/turf/wall/untinted/onestar_reinforced,
/area/crawler)
"t" = (
/obj/spawner/mob/roomba,
/turf/floor/tiled/derelict,
/area/crawler)
"u" = (
/turf/floor/tiled/derelict,
/area/crawler)
"v" = (
/obj/effect/floor_decal/industrial/warning/corner{
	dir = 4
	},
/turf/floor/tiled/derelict,
/area/crawler)
"w" = (
/obj/effect/floor_decal/industrial/warning{
	dir = 1
	},
/turf/floor/tiled/derelict,
/area/crawler)
"y" = (
/obj/structure/bed,
/turf/floor/tiled/dark/brown_platform,
/area/crawler)
"z" = (
/obj/structure/window/reinforced{
	dir = 1
	},
/obj/effect/floor_decal/industrial/warning,
/turf/floor/tiled/dark/brown_perforated,
/area/crawler)
"B" = (
/obj/effect/floor_decal/industrial/warning,
/obj/machinery/door/window{
	dir = 1
	},
/turf/floor/tiled/dark/brown_perforated,
/area/crawler)
"C" = (
/turf/wall/low/onestar,
/area/crawler)
"H" = (
/obj/structure/table/onestar,
/obj/item/handcuffs,
/obj/item/gun/energy/retro,
/turf/floor/tiled/dark/brown_perforated,
/area/crawler)
"J" = (
/obj/landmark/corpse/one_star/void,
/turf/floor/tiled/dark/brown_platform,
/area/crawler)
"N" = (
/obj/item/remains,
/turf/floor/tiled/dark/brown_platform,
/area/crawler)

(1,1,1) = {"
a
a
a
b
b
b
a
a
a
"}
(2,1,1) = {"
a
c
k
q
v
u
z
y
a
"}
(3,1,1) = {"
a
d
d
r
w
u
B
N
a
"}
(4,1,1) = {"
a
e
a
s
u
p
a
a
a
"}
(5,1,1) = {"
a
f
l
a
u
u
z
y
b
"}
(6,1,1) = {"
b
g
J
C
u
t
B
g
b
"}
(7,1,1) = {"
b
h
m
C
u
p
a
a
b
"}
(8,1,1) = {"
b
g
g
C
u
u
B
g
b
"}
(9,1,1) = {"
a
i
H
a
t
u
z
y
b
"}
(10,1,1) = {"
a
a
a
s
u
p
a
a
a
"}
(11,1,1) = {"
a
j
n
u
u
u
B
g
a
"}
(12,1,1) = {"
a
j
n
u
u
u
z
y
a
"}
(13,1,1) = {"
a
a
o
b
b
b
o
a
a
"}
