//MAP CONVERTED BY dmm2tgm.py THIS HEADER COMMENT PREVENTS RECONVERSION, DO NOT REMOVE
"a" = (
/turf/wall/untinted/onestar_reinforced,
/area/crawler)
"b" = (
/obj/crawler/crawler_wallbreaker,
/turf/wall/untinted/onestar_reinforced,
/area/crawler)
"c" = (
/obj/structure/closet/secure_closet/personal,
/turf/floor/tiled/derelict,
/area/crawler)
"d" = (
/obj/structure/closet/onestar/tier3/special,
/turf/floor/tiled/derelict,
/area/crawler)
"e" = (
/turf/floor/tiled/derelict,
/area/crawler)
"f" = (
/obj/structure/grille,
/turf/floor/tiled/derelict/white_small_edges,
/area/crawler)
"g" = (
/turf/floor/tiled/derelict/white_small_edges,
/area/crawler)
"h" = (
/obj/machinery/light/floor,
/turf/floor/tiled/derelict/white_small_edges,
/area/crawler)
"i" = (
/obj/machinery/light/floor,
/turf/floor/tiled/derelict/white_big_edges,
/area/crawler)
"j" = (
/obj/structure/railing/grey{
	dir = 1
	},
/obj/machinery/light/floor,
/turf/floor/tiled/derelict,
/area/crawler)
"k" = (
/obj/structure/railing/grey{
	dir = 1
	},
/turf/floor/tiled/derelict,
/area/crawler)
"l" = (
/obj/crawler/crawler_wallbreaker/vertical,
/turf/wall/untinted/onestar_reinforced,
/area/crawler)
"m" = (
/turf/floor/bluegrid,
/area/crawler)
"n" = (
/obj/effect/floor_decal/industrial/warning{
	dir = 4
	},
/turf/floor/tiled/derelict/white_big_edges,
/area/crawler)
"o" = (
/obj/structure/table/onestar,
/turf/floor/tiled/derelict/white_small_edges,
/area/crawler)
"p" = (
/obj/structure/target_stake,
/turf/floor/tiled/derelict/white_big_edges,
/area/crawler)
"q" = (
/obj/crawler/crawler_wallbreaker/vertical,
/turf/floor/bluegrid,
/area/crawler)
"r" = (
/obj/structure/safe/floor{
	contents = newlist(/obj/spawner/credits/c1000)
	},
/obj/item/tool/crowbar/onestar,
/turf/floor/tiled/derelict,
/area/crawler)
"s" = (
/obj/structure/railing/grey,
/obj/machinery/light/floor,
/turf/floor/tiled/derelict,
/area/crawler)
"t" = (
/obj/structure/railing/grey,
/turf/floor/tiled/derelict,
/area/crawler)
"u" = (
/obj/structure/window/reinforced{
	dir = 8
	},
/obj/machinery/door/window/northleft,
/obj/structure/table/rack,
/obj/spawner/gun/normal,
/obj/spawner/gun/normal,
/obj/spawner/gun/onestar/low_chance,
/turf/floor/tiled/derelict,
/area/crawler)
"v" = (
/obj/structure/window/reinforced{
	dir = 4
	},
/obj/machinery/door/window/northright,
/obj/structure/table/rack,
/obj/spawner/gun/shotgun,
/obj/spawner/gun/onestar,
/turf/floor/tiled/derelict,
/area/crawler)
"x" = (
/obj/structure/mopbucket,
/turf/floor/tiled/derelict/white_small_edges,
/area/crawler)
"y" = (
/obj/spawner/mob/roomba,
/turf/floor/tiled/derelict/white_small_edges,
/area/crawler)
"z" = (
/obj/structure/table/onestar,
/obj/spawner/gun/onestar,
/turf/floor/tiled/derelict,
/area/crawler)
"C" = (
/mob/living/carbon/superior_animal/stalker,
/turf/floor/tiled/derelict/white_small_edges,
/area/crawler)
"G" = (
/obj/structure/table/onestar,
/obj/spawner/gun/onestar/low_chance,
/turf/floor/tiled/derelict/white_small_edges,
/area/crawler)
"M" = (
/mob/living/carbon/superior_animal/stalker/dual,
/turf/floor/tiled/derelict/white_small_edges,
/area/crawler)
"Q" = (
/obj/structure/table/onestar,
/obj/item/gun/projectile/pistol/type_90,
/turf/floor/tiled/derelict/white_small_edges,
/area/crawler)
"W" = (
/obj/effect/floor_decal/industrial/warning{
	dir = 8
	},
/turf/floor/tiled/derelict,
/area/crawler)

(1,1,1) = {"
a
a
a
m
m
q
a
a
a
"}
(2,1,1) = {"
a
c
h
g
g
g
h
u
a
"}
(3,1,1) = {"
a
c
g
M
g
C
g
v
a
"}
(4,1,1) = {"
a
c
g
g
g
g
y
z
a
"}
(5,1,1) = {"
a
d
y
g
y
g
g
z
b
"}
(6,1,1) = {"
b
e
i
n
n
n
i
e
b
"}
(7,1,1) = {"
b
f
a
Q
G
o
a
f
b
"}
(8,1,1) = {"
b
g
j
W
W
W
s
g
b
"}
(9,1,1) = {"
a
g
k
e
e
e
t
g
b
"}
(10,1,1) = {"
a
g
k
e
e
e
t
g
a
"}
(11,1,1) = {"
a
g
e
p
r
p
e
g
a
"}
(12,1,1) = {"
a
g
k
e
e
e
t
x
a
"}
(13,1,1) = {"
a
a
l
l
l
l
l
a
a
"}
