"a" = (/turf/simulated/wall/untinted/onestar_reinforced,/area/crawler)
"b" = (/obj/machinery/light/floor,/turf/simulated/floor/tiled/cafe,/area/crawler)
"c" = (/turf/simulated/floor/tiled/cafe,/area/crawler)
"d" = (/obj/machinery/optable,/turf/simulated/floor/tiled/cafe,/area/crawler)
"e" = (/obj/structure/curtain/medical,/obj/structure/low_wall,/obj/effect/window_lwall_spawn,/turf/simulated/floor/tiled/derelict/white_small_edges,/area/crawler)
"f" = (/obj/crawler/crawler_wallbreaker/vertical,/turf/simulated/wall/untinted/onestar_reinforced,/area/crawler)
"g" = (/obj/machinery/light/floor,/obj/effect/floor_decal/industrial/danger{dir = 8},/turf/simulated/floor/tiled/derelict,/area/crawler)
"h" = (/obj/structure/table/onestar,/turf/simulated/floor/tiled/cafe,/area/crawler)
"i" = (/obj/crawler/crawler_wallbreaker,/turf/simulated/wall/untinted/onestar_reinforced,/area/crawler)
"j" = (/turf/simulated/floor/tiled/derelict,/area/crawler)
"k" = (/obj/structure/window/reinforced,/obj/machinery/computer/operating{dir = 4},/turf/simulated/floor/tiled/cafe,/area/crawler)
"l" = (/obj/machinery/door/window/southright,/turf/simulated/floor/tiled/cafe,/area/crawler)
"m" = (/obj/structure/window/reinforced,/obj/structure/table/onestar,/turf/simulated/floor/tiled/cafe,/area/crawler)
"n" = (/obj/machinery/door/window/southleft,/turf/simulated/floor/tiled/cafe,/area/crawler)
"o" = (/obj/structure/window/reinforced,/obj/machinery/computer/operating{dir = 8},/turf/simulated/floor/tiled/cafe,/area/crawler)
"p" = (/obj/effect/floor_decal/industrial/outline,/obj/structure/medical_stand,/turf/simulated/floor/tiled/derelict,/area/crawler)
"q" = (/obj/machinery/light/floor,/obj/effect/floor_decal/industrial/danger{dir = 4},/turf/simulated/floor/tiled/derelict,/area/crawler)
"r" = (/obj/effect/floor_decal/industrial/danger{dir = 4},/obj/machinery/light/floor,/turf/simulated/floor/tiled/derelict,/area/crawler)
"s" = (/obj/effect/floor_decal/industrial/outline,/turf/simulated/floor/tiled/derelict,/area/crawler)
"t" = (/obj/machinery/door/airlock/freezer,/turf/simulated/floor/tiled/techmaint,/area/crawler)
"u" = (/obj/effect/floor_decal/industrial/danger{dir = 8},/obj/effect/floor_decal/sign,/turf/simulated/floor/tiled/derelict,/area/crawler)
"v" = (/obj/effect/floor_decal/industrial/danger{dir = 4},/obj/effect/floor_decal/sign/two,/turf/simulated/floor/tiled/derelict,/area/crawler)
"w" = (/obj/effect/floor_decal/industrial/outline,/obj/structure/table/rack,/turf/simulated/floor/tiled/derelict,/area/crawler)
"x" = (/obj/random/mob/roomba,/turf/simulated/floor/tiled/derelict,/area/crawler)
"y" = (/obj/structure/low_wall,/obj/effect/window_lwall_spawn,/turf/simulated/floor/tiled/derelict/white_small_edges,/area/crawler)
"z" = (/obj/structure/window/reinforced{dir = 1},/obj/machinery/washing_machine,/turf/simulated/floor/tiled/cafe,/area/crawler)
"A" = (/obj/machinery/door/window/northright,/turf/simulated/floor/tiled/cafe,/area/crawler)
"B" = (/obj/structure/window/reinforced{dir = 1},/obj/structure/table/onestar,/turf/simulated/floor/tiled/cafe,/area/crawler)
"D" = (/obj/machinery/door/window/northleft,/turf/simulated/floor/tiled/cafe,/area/crawler)

(1,1,1) = {"
aaaaaiiiaaaaa
adbhejjjehbda
aklmejxjemnof
apjjagxqajjpf
asjjtujvtjjsf
fwjjagxrajjwf
azAByjjjyBDzf
acbhyjxjyhbca
aaaaiiiiiaaaa
"}
