"ah" = (/turf/shuttle/wall/science{icon_state = "12,1"},/area/space)
"aj" = (/obj/machinery/light/small,/turf/shuttle/floor/science{icon_state = "10,7"},/area/space)
"ap" = (/turf/shuttle/wall/science{icon_state = "9,9"},/area/space)
"aS" = (/obj/machinery/atmospherics/pipe/manifold4w/hidden/supply,/turf/shuttle/floor/science{icon_state = "8,11"},/area/space)
"aW" = (/obj/structure/shuttle_part/science{icon_state = "12,17"},/turf/template_noop,/area/space)
"aY" = (/obj/machinery/atmospherics/pipe/simple/hidden/supply{dir = 4},/obj/machinery/door/airlock/freezer{name = "Vasiliy Dokuchaev Internal Airlock"; req_access = list(5)},/turf/shuttle/floor/science{icon_state = "9,8"},/area/space)
"bd" = (/obj/machinery/suit_storage_unit/moebius,/turf/shuttle/floor/science{icon_state = "11,9"},/area/space)
"bm" = (/obj/structure/cable/yellow{d1 = 2; d2 = 8; icon_state = "2-8"},/turf/shuttle/floor/science{icon_state = "4,3"},/area/space)
"br" = (/turf/shuttle/wall/science{icon_state = "12,8"},/area/space)
"bz" = (/turf/shuttle/wall/science{icon_state = "10,13"},/area/space)
"bI" = (/obj/structure/shuttle_part/science{icon_state = "11,0"},/turf/template_noop,/area/space)
"bK" = (/obj/machinery/light/small{dir = 1},/turf/shuttle/floor/science{icon_state = "10,12"},/area/space)
"cl" = (/obj/machinery/atmospherics/pipe/tank/air,/turf/shuttle/floor/science{icon_state = "5,5"},/area/space)
"co" = (/turf/shuttle/wall/science{icon_state = "8,0"},/area/space)
"cI" = (/obj/structure/table/standard,/obj/machinery/camera/network/research_outpost{dir = 1},/obj/machinery/recharger,/turf/shuttle/floor/science{icon_state = "7,17"},/area/space)
"cM" = (/obj/machinery/atmospherics/pipe/simple/hidden/universal,/turf/shuttle/floor/science{icon_state = "5,4"},/area/space)
"cX" = (/obj/machinery/atmospherics/unary/vent_pump/on{dir = 8},/turf/shuttle/floor/science{icon_state = "10,4"},/area/space)
"dd" = (/turf/shuttle/wall/science{icon_state = "13,7"},/area/space)
"df" = (/turf/shuttle/wall/science{icon_state = "4,16"},/area/space)
"dk" = (/obj/machinery/atmospherics/pipe/simple/hidden/supply,/turf/shuttle/floor/science{icon_state = "8,3"},/area/space)
"ds" = (/obj/item/tool/pickaxe/excavation,/obj/item/tool/pickaxe,/obj/item/tool/wrench,/obj/item/device/measuring_tape,/obj/structure/table/steel,/obj/item/stack/flag/yellow,/obj/machinery/light/small{dir = 4},/turf/shuttle/floor/science{icon_state = "13,3"},/area/space)
"dF" = (/obj/machinery/computer/shuttle_control/explore/exploration_shuttle,/turf/shuttle/floor/science{icon_state = "8,18"},/area/space)
"dG" = (/obj/structure/table/standard,/obj/item/storage/firstaid/toxin,/obj/item/storage/firstaid/fire,/obj/item/storage/firstaid/o2,/obj/item/storage/firstaid/regular,/turf/shuttle/floor/science{icon_state = "11,12"},/area/space)
"dR" = (/turf/shuttle/wall/science{icon_state = "10,10"},/area/space)
"dZ" = (/obj/structure/shuttle_part/science{icon_state = "14,10"},/turf/template_noop,/area/space)
"eb" = (/obj/machinery/camera/network/research_outpost{dir = 1},/obj/machinery/atmospherics/unary/vent_pump/high_volume{dir = 4; frequency = 1380; id_tag = "research_shuttle_pump"; power_rating = 30000},/turf/shuttle/floor/science{icon_state = "6,11"},/area/space)
"el" = (/obj/machinery/atmospherics/pipe/simple/hidden/supply{dir = 4},/obj/machinery/door/airlock/freezer{name = "Vasiliy Dokuchaev Internal Airlock"; req_access = list(5)},/turf/shuttle/floor/science{icon_state = "7,8"},/area/space)
"eo" = (/turf/shuttle/wall/science{icon_state = "5,2"},/area/space)
"er" = (/obj/structure/shuttle_part/science{icon_state = "15,2"},/turf/template_noop,/area/space)
"ex" = (/obj/machinery/atmospherics/pipe/simple/hidden/supply{dir = 5},/turf/shuttle/floor/science{icon_state = "5,3"},/area/space)
"eZ" = (/obj/machinery/atmospherics/pipe/simple/hidden/supply{dir = 10},/obj/machinery/access_button{command = "cycle_interior"; frequency = 1380; master_tag = "vasiliy_dokuchaev_shuttle"; name = "interior access button"; pixel_y = 25; req_one_access = list(5)},/turf/shuttle/floor/science{icon_state = "7,12"},/area/space)
"fr" = (/turf/shuttle/wall/science{icon_state = "9,3"},/area/space)
"ft" = (/turf/shuttle/wall/science{icon_state = "4,7"},/area/space)
"fM" = (/obj/structure/shuttle_part/science{icon_state = "13,8"},/turf/template_noop,/area/space)
"fO" = (/turf/shuttle/wall/science{icon_state = "10,18"; opacity = 0},/area/space)
"gl" = (/obj/machinery/atmospherics/pipe/manifold4w/hidden/supply,/turf/shuttle/floor/science{icon_state = "8,4"},/area/space)
"gp" = (/turf/shuttle/wall/science{icon_state = "5,13"},/area/space)
"gy" = (/turf/shuttle/wall/science{icon_state = "2,6"},/area/space)
"gW" = (/obj/machinery/suit_storage_unit/moebius,/turf/shuttle/floor/science{icon_state = "11,7"},/area/space)
"hq" = (/turf/shuttle/floor/science{icon_state = "5,9"},/area/space)
"hB" = (/obj/structure/shuttle_part/science{icon_state = "2,0"},/turf/template_noop,/area/space)
"hI" = (/obj/machinery/atmospherics/unary/vent_pump/on{dir = 8},/turf/shuttle/floor/science{icon_state = "9,11"},/area/space)
"ic" = (/turf/shuttle/wall/science{icon_state = "10,17"; opacity = 0},/area/space)
"iq" = (/turf/shuttle/floor/science{icon_state = "4,4"},/area/space)
"iu" = (/turf/shuttle/wall/science{icon_state = "9,6"},/area/space)
"iv" = (/turf/shuttle/floor/science{icon_state = "5,7"},/area/space)
"ix" = (/turf/shuttle/wall/science{icon_state = "11,6"},/area/space)
"iz" = (/obj/machinery/atmospherics/unary/vent_pump/high_volume{dir = 4; frequency = 1380; id_tag = "research_shuttle_pump"; power_rating = 30000},/obj/machinery/airlock_sensor{frequency = 1380; id_tag = "research_shuttle_sensor"; pixel_y = 25},/turf/shuttle/floor/science{icon_state = "6,12"},/area/space)
"iL" = (/turf/shuttle/wall/science{icon_state = "7,1"},/area/space)
"iX" = (/turf/shuttle/wall/science{icon_state = "12,11"},/area/space)
"jE" = (/obj/structure/shuttle_part/science{icon_state = "14,8"},/turf/template_noop,/area/space)
"jF" = (/obj/structure/table/standard,/obj/machinery/light/small,/turf/shuttle/floor/science{icon_state = "9,17"},/area/space)
"jT" = (/turf/shuttle/wall/science{icon_state = "7,15"},/area/space)
"kP" = (/obj/structure/shuttle_part/science{icon_state = "2,9"},/turf/template_noop,/area/space)
"kT" = (/obj/machinery/camera/network/research_outpost,/obj/machinery/doppler_array,/turf/shuttle/floor/science{icon_state = "6,15"},/area/space)
"kW" = (/turf/shuttle/wall/science{icon_state = "12,14"},/area/space)
"li" = (/obj/structure/bed/chair{dir = 1},/obj/machinery/atmospherics/unary/vent_pump/on,/turf/shuttle/floor/science{icon_state = "8,17"},/area/space)
"lz" = (/turf/shuttle/wall/science{icon_state = "11,10"},/area/space)
"lL" = (/turf/shuttle/wall/science{icon_state = "12,15"},/area/space)
"mb" = (/turf/shuttle/wall/science{icon_state = "6,16"},/area/space)
"mh" = (/obj/structure/shuttle_part/science{icon_state = "2,7"},/turf/space,/area/space)
"ms" = (/turf/shuttle/wall/science{icon_state = "9,1"},/area/space)
"ns" = (/turf/shuttle/wall/science{icon_state = "12,9"},/area/space)
"nt" = (/obj/structure/table/standard,/obj/item/device/lighting/toggleable/lamp,/turf/shuttle/floor/science{icon_state = "5,15"},/area/space)
"nF" = (/turf/shuttle/wall/science{icon_state = "14,6"},/area/space)
"nG" = (/turf/shuttle/wall/science{icon_state = "4,15"},/area/space)
"nH" = (/obj/structure/dispenser/oxygen,/turf/shuttle/floor/science{icon_state = "10,5"},/area/space)
"nM" = (/turf/shuttle/wall/science{icon_state = "5,6"},/area/space)
"ov" = (/obj/machinery/atmospherics/pipe/simple/hidden/supply,/turf/shuttle/floor/science{icon_state = "8,12"},/area/space)
"oz" = (/obj/machinery/power/port_gen/pacman{anchored = 1},/obj/structure/cable/yellow,/turf/floor,/area/space)
"oE" = (/obj/structure/shuttle_part/science{icon_state = "15,7"},/turf/template_noop,/area/space)
"oM" = (/turf/shuttle/floor/science{icon_state = "5,8"},/area/space)
"oV" = (/turf/shuttle/wall/science{icon_state = "9,13"},/area/space)
"pn" = (/turf/shuttle/wall/science{icon_state = "6,17"; opacity = 0},/area/space)
"pv" = (/obj/machinery/suit_storage_unit/moebius,/turf/shuttle/floor/science{icon_state = "11,8"},/area/space)
"pw" = (/turf/shuttle/wall/science{icon_state = "4,9"},/area/space)
"px" = (/turf/shuttle/floor/science{icon_state = "11,4"},/area/space)
"pF" = (/turf/shuttle/wall/science{icon_state = "5,16"},/area/space)
"pG" = (/obj/structure/shuttle_part/science{icon_state = "2,8"},/turf/space,/area/space)
"pP" = (/obj/item/tool/pickaxe/excavation,/obj/item/tool/pickaxe,/obj/item/tool/wrench,/obj/item/device/measuring_tape,/obj/structure/table/steel,/obj/item/stack/flag/yellow,/turf/shuttle/floor/science{icon_state = "13,2"},/area/space)
"pU" = (/obj/structure/shuttle_part/science{icon_state = "15,3"},/turf/template_noop,/area/space)
"qr" = (/turf/shuttle/wall/science{icon_state = "12,12"},/area/space)
"qL" = (/obj/structure/shuttle_part/science{icon_state = "6,20"},/turf/template_noop,/area/space)
"re" = (/turf/shuttle/wall/science{icon_state = "7,13"},/area/space)
"rr" = (/turf/shuttle/wall/science{icon_state = "4,8"},/area/space)
"rA" = (/turf/shuttle/floor/science{icon_state = "10,11"},/area/space)
"rQ" = (/turf/shuttle/wall/science{icon_state = "10,2"},/area/space)
"sd" = (/obj/machinery/atmospherics/pipe/manifold4w/hidden/supply,/turf/shuttle/floor/science{icon_state = "8,16"},/area/space)
"sy" = (/turf/shuttle/wall/science{opacity = 0},/area/space)
"sE" = (/turf/shuttle/wall/science{icon_state = "4,1"},/area/space)
"sI" = (/obj/machinery/atmospherics/pipe/simple/hidden/supply{dir = 4},/obj/machinery/door/airlock/freezer{name = "Vasiliy Dokuchaev Internal Airlock"; req_access = list(5)},/turf/shuttle/floor/science{icon_state = "7,14"},/area/space)
"sK" = (/turf/shuttle/wall/science{icon_state = "12,7"},/area/space)
"ti" = (/turf/shuttle/wall/science{icon_state = "6,1"},/area/space)
"tq" = (/obj/machinery/atmospherics/pipe/simple/hidden/supply,/obj/machinery/door/airlock/freezer{name = "Vasiliy Dokuchaev Internal Airlock"; req_access = list(5)},/turf/shuttle/floor/science{icon_state = "8,16"},/area/space)
"uk" = (/obj/structure/table/standard,/obj/item/storage/toolbox/mechanical,/turf/shuttle/floor/science{icon_state = "9,18"},/area/space)
"um" = (/turf/shuttle/wall/science{icon_state = "2,4"},/area/space)
"ur" = (/obj/structure/shuttle_part/science{icon_state = "8,21"},/turf/template_noop,/area/space)
"uy" = (/obj/machinery/embedded_controller/radio/airlock/docking_port{frequency = 1380; id_tag = "vasiliy_dokuchaev_shuttle"; pixel_y = 28; req_one_access = list(5); tag_airpump = "research_shuttle_pump"; tag_chamber_sensor = "research_shuttle_sensor"; tag_exterior_door = "research_shuttle_outer"; tag_interior_door = "research_shuttle_inner"},/turf/shuttle/floor/science{icon_state = "5,12"},/area/space)
"uA" = (/turf/shuttle/wall/science{icon_state = "9,19"; opacity = 0},/area/space)
"uO" = (/obj/structure/shuttle_part/science{icon_state = "3,8"},/turf/space,/area/space)
"vn" = (/obj/machinery/atmospherics/pipe/manifold/hidden/supply,/obj/machinery/door/airlock/multi_tile/metal{dir = 2; frequency = 1380; icon_state = "door_locked"; id_tag = "research_shuttle_inner"; locked = 1; name = "Vasiliy Dokuchaev Internal Access"; req_access = list(5)},/turf/shuttle/floor/science{icon_state = "7,11"},/area/space)
"vt" = (/obj/machinery/door/airlock/multi_tile/metal{dir = 2; frequency = 1380; icon_state = "door_locked"; id_tag = "research_shuttle_outer"; locked = 1; name = "Vasiliy Dokuchaev External Access"; req_access = list(5)},/turf/shuttle/floor/science{icon_state = "4,11"},/area/space)
"vD" = (/turf/shuttle/wall/science{icon_state = "7,6"},/area/space)
"vE" = (/turf/shuttle/wall/science{icon_state = "6,2"},/area/space)
"wB" = (/turf/shuttle/wall/science{icon_state = "9,16"},/area/space)
"wD" = (/obj/structure/shuttle_part/science{icon_state = "5,17"},/turf/template_noop,/area/space)
"xj" = (/obj/structure/shuttle_part/science{icon_state = "14,9"},/turf/template_noop,/area/space)
"xD" = (/obj/machinery/atmospherics/unary/vent_pump/on{dir = 8},/turf/shuttle/floor/science{icon_state = "10,8"},/area/space)
"xE" = (/obj/structure/shuttle_part/science{icon_state = "7,20"},/turf/template_noop,/area/space)
"xR" = (/obj/structure/shuttle_part/science{icon_state = "15,8"},/turf/template_noop,/area/space)
"xT" = (/turf/shuttle/wall/science{icon_state = "7,0"},/area/space)
"xU" = (/obj/structure/shuttle_part/science{icon_state = "13,10"},/turf/template_noop,/area/space)
"ym" = (/obj/machinery/camera/network/research_outpost,/turf/shuttle/floor/science{icon_state = "6,9"},/area/space)
"yn" = (/obj/structure/table/standard,/obj/machinery/power/apc{dir = 1; name = "North APC"; pixel_y = 28},/obj/structure/cable{d2 = 8; icon_state = "0-8"},/obj/item/stack/material/plasma{amount = 25},/obj/item/tank/plasma,/obj/item/tank/plasma,/turf/shuttle/floor/science{icon_state = "4,5"},/area/space)
"yx" = (/turf/shuttle/wall/science{icon_state = "7,5"},/area/space)
"yY" = (/turf/shuttle/wall/science{icon_state = "9,5"},/area/space)
"zf" = (/turf/shuttle/wall/science{icon_state = "14,1"},/area/space)
"zn" = (/turf/shuttle/wall/science{icon_state = "12,13"},/area/space)
"zS" = (/turf/shuttle/wall/science{icon_state = "13,1"},/area/space)
"Ad" = (/turf/shuttle/wall/science{icon_state = "6,10"},/area/space)
"AE" = (/turf/shuttle/wall/science{icon_state = "9,15"},/area/space)
"Bb" = (/obj/machinery/atmospherics/unary/vent_pump/on{dir = 8},/obj/machinery/light/small,/turf/shuttle/floor/science{icon_state = "10,14"},/area/space)
"BP" = (/turf/shuttle/wall/science{icon_state = "2,5"},/area/space)
"BQ" = (/obj/machinery/atmospherics/pipe/simple/hidden/supply{dir = 4},/obj/machinery/door/airlock/freezer{name = "Vasiliy Dokuchaev Internal Airlock"; req_access = list(5)},/turf/shuttle/floor/science{icon_state = "9,4"},/area/space)
"BR" = (/obj/machinery/atmospherics/pipe/manifold4w/hidden/supply,/turf/shuttle/floor/science{icon_state = "8,8"},/area/space)
"BX" = (/turf/shuttle/wall/science{icon_state = "13,6"},/area/space)
"BZ" = (/obj/item/device/radio/beacon,/obj/machinery/camera/network/research_outpost,/turf/shuttle/floor/science{icon_state = "9,12"},/area/space)
"Ci" = (/turf/shuttle/wall/science{icon_state = "14,5"},/area/space)
"Cv" = (/obj/structure/shuttle_part/science{icon_state = "1,5"},/turf/template_noop,/area/space)
"Cx" = (/obj/machinery/atmospherics/pipe/simple/hidden/supply{dir = 4},/obj/machinery/door/airlock/freezer{name = "Vasiliy Dokuchaev Internal Airlock"; req_access = list(5)},/turf/shuttle/floor/science{icon_state = "7,4"},/area/space)
"CA" = (/turf/shuttle/wall/science{icon_state = "12,10"},/area/space)
"CG" = (/obj/structure/shuttle_part/science{icon_state = "13,0"},/turf/template_noop,/area/space)
"CH" = (/obj/structure/shuttle_part/science{icon_state = "6,0"},/turf/template_noop,/area/space)
"CO" = (/obj/structure/shuttle_part/science{icon_state = "15,6"},/turf/template_noop,/area/space)
"CY" = (/obj/structure/shuttle_part/science{icon_state = "13,12"},/turf/template_noop,/area/space)
"Df" = (/obj/machinery/atmospherics/pipe/simple/hidden/supply,/obj/machinery/door/airlock/freezer{name = "Vasiliy Dokuchaev Internal Airlock"; req_access = list(5)},/turf/shuttle/floor/science{icon_state = "8,10"},/area/space)
"Dl" = (/turf/shuttle/wall/science{icon_state = "4,6"},/area/space)
"Dm" = (/obj/structure/shuttle_part/science{icon_state = "1,0"},/turf/template_noop,/area/space)
"Ds" = (/obj/machinery/atmospherics/pipe/simple/hidden/supply,/obj/machinery/light/small{dir = 4},/turf/shuttle/floor/science,/area/space)
"DH" = (/obj/structure/shuttle_part/science{icon_state = "13,9"},/turf/template_noop,/area/space)
"Eb" = (/obj/structure/table/standard,/obj/item/device/lighting/toggleable/lamp,/turf/shuttle/floor/science{icon_state = "11,15"},/area/space)
"Ee" = (/obj/structure/shuttle_part/science{icon_state = "3,0"},/turf/template_noop,/area/space)
"Ek" = (/obj/structure/table/standard,/obj/item/storage/box/donut,/turf/shuttle/floor/science{icon_state = "7,18"},/area/space)
"Ep" = (/turf/shuttle/wall/science{icon_state = "4,14"},/area/space)
"EM" = (/obj/machinery/power/smes/buildable{RCon_tag = "Hulk Mining Barge"; charge = 1.5e+007; cur_coils = 3; input_attempt = 1; input_level = 750000; input_level_max = 750000; output_attempt = 1; output_level = 750000; output_level_max = 750000},/obj/structure/cable{d2 = 4; icon_state = "0-4"},/turf/floor,/area/space)
"EP" = (/obj/machinery/floodlight,/turf/shuttle/floor/science{icon_state = "11,3"},/area/space)
"Fj" = (/turf/shuttle/wall/science{icon_state = "7,2"},/area/space)
"FB" = (/obj/machinery/floodlight,/turf/shuttle/floor/science{icon_state = "10,3"},/area/space)
"FT" = (/obj/machinery/atmospherics/pipe/manifold/hidden/supply{dir = 8},/turf/shuttle/floor/science{icon_state = "6,4"},/area/space)
"Gi" = (/obj/structure/shuttle_part/science{icon_state = "15,0"},/turf/template_noop,/area/space)
"GG" = (/turf/shuttle/wall/science{icon_state = "14,2"},/area/space)
"GT" = (/obj/machinery/atmospherics/unary/vent_pump/on{dir = 1},/turf/shuttle/floor/science{icon_state = "8,1"},/area/space)
"Hg" = (/turf/shuttle/wall/science{icon_state = "9,10"},/area/space)
"Hp" = (/turf/shuttle/wall/science{icon_state = "3,6"},/area/space)
"Ht" = (/turf/shuttle/floor/science{icon_state = "12,2"},/area/space)
"Hu" = (/turf/shuttle/wall/science{icon_state = "9,0"},/area/space)
"Hv" = (/obj/structure/shuttle_part/science{icon_state = "11,17"},/turf/template_noop,/area/space)
"Hx" = (/obj/structure/shuttle_part/science{icon_state = "15,5"},/turf/template_noop,/area/space)
"HW" = (/obj/structure/shuttle_part/science{icon_state = "1,3"},/turf/template_noop,/area/space)
"Ii" = (/turf/shuttle/floor/science{icon_state = "12,3"},/area/space)
"Il" = (/turf/shuttle/wall/science{icon_state = "2,1"},/area/space)
"IA" = (/obj/structure/shuttle_part/science{icon_state = "3,9"},/turf/template_noop,/area/space)
"IG" = (/obj/structure/shuttle_part/science{icon_state = "6,19"},/turf/template_noop,/area/space)
"IO" = (/turf/shuttle/wall/science{icon_state = "7,16"},/area/space)
"IR" = (/obj/machinery/atmospherics/pipe/simple/hidden/supply{dir = 4},/obj/machinery/door/airlock/freezer{name = "Vasiliy Dokuchaev Internal Airlock"; req_access = list(5)},/turf/shuttle/floor/science{icon_state = "9,14"},/area/space)
"IV" = (/obj/structure/bed/chair{dir = 8},/turf/shuttle/floor/science{icon_state = "11,14"},/area/space)
"IZ" = (/obj/machinery/atmospherics/pipe/simple/hidden/supply,/obj/machinery/door/airlock/freezer{name = "Vasiliy Dokuchaev Internal Airlock"; req_access = list(5)},/turf/shuttle/floor/science{icon_state = "8,14"},/area/space)
"Ja" = (/obj/structure/shuttle_part/science{icon_state = "5,0"},/turf/template_noop,/area/space)
"Jd" = (/obj/structure/shuttle_part/science{icon_state = "1,8"},/turf/template_noop,/area/space)
"Ji" = (/turf/shuttle/wall/science{icon_state = "6,13"},/area/space)
"Jp" = (/obj/structure/shuttle_part/science{icon_state = "1,4"},/turf/template_noop,/area/space)
"JQ" = (/obj/machinery/atmospherics/pipe/simple/hidden/supply,/obj/machinery/camera/network/research_outpost{dir = 8},/obj/machinery/light/small{dir = 8},/turf/shuttle/floor/science{icon_state = "8,6"},/area/space)
"JV" = (/turf/shuttle/wall/science{icon_state = "6,6"},/area/space)
"JZ" = (/turf/shuttle/wall/science{icon_state = "11,16"},/area/space)
"KO" = (/turf/shuttle/wall/science{icon_state = "8,19"; opacity = 0},/area/space)
"Lc" = (/obj/structure/shuttle_part/science{icon_state = "9,21"},/turf/template_noop,/area/space)
"Lm" = (/obj/structure/shuttle_part/science{icon_state = "4,17"},/turf/template_noop,/area/space)
"LB" = (/turf/shuttle/wall/science{icon_state = "14,7"},/area/space)
"LF" = (/obj/machinery/atmospherics/unary/vent_pump/on{dir = 4},/obj/machinery/light/small,/turf/shuttle/floor/science{icon_state = "6,14"},/area/space)
"Md" = (/turf/shuttle/wall/science{icon_state = "5,10"},/area/space)
"Mz" = (/turf/shuttle/wall/science{icon_state = "9,2"},/area/space)
"MN" = (/obj/machinery/camera/network/research_outpost,/turf/shuttle/floor/science{icon_state = "10,9"},/area/space)
"NC" = (/obj/machinery/light/small,/turf/shuttle/floor/science{icon_state = "5,11"},/area/space)
"NM" = (/obj/machinery/atmospherics/pipe/simple/hidden/supply{dir = 9},/obj/structure/fuel_port{pixel_y = -32},/turf/shuttle/floor/science{icon_state = "6,3"},/area/space)
"Or" = (/obj/structure/shuttle_part/science{icon_state = "10,19"},/turf/template_noop,/area/space)
"OC" = (/turf/shuttle/wall/science{icon_state = "10,16"},/area/space)
"OD" = (/turf/template_noop,/area/space)
"OO" = (/obj/machinery/camera/network/research_outpost,/turf/shuttle/floor/science{icon_state = "12,5"},/area/space)
"OX" = (/turf/shuttle/wall/science{icon_state = "12,16"},/area/space)
"Pn" = (/obj/structure/shuttle_part/science{icon_state = "14,0"},/turf/template_noop,/area/space)
"Pq" = (/turf/shuttle/wall/science{icon_state = "10,6"},/area/space)
"PI" = (/turf/shuttle/wall/science{icon_state = "3,1"},/area/space)
"Qh" = (/obj/structure/shuttle_part/science{icon_state = "10,20"},/turf/template_noop,/area/space)
"Qs" = (/obj/machinery/light/small,/turf/shuttle/floor/science{icon_state = "6,7"},/area/space)
"Qv" = (/turf/shuttle/floor/science{icon_state = "11,5"},/area/space)
"Qw" = (/obj/structure/bed/chair{dir = 4},/turf/shuttle/floor/science{icon_state = "5,14"},/area/space)
"Qy" = (/turf/shuttle/wall/science{icon_state = "4,10"},/area/space)
"QO" = (/turf/shuttle/wall/science{icon_state = "11,1"},/area/space)
"QV" = (/turf/shuttle/wall/science{icon_state = "5,1"},/area/space)
"Rg" = (/obj/machinery/atmospherics/unary/vent_pump/on{dir = 4},/turf/shuttle/floor/science{icon_state = "6,8"},/area/space)
"Ri" = (/turf/shuttle/wall/science{icon_state = "14,3"},/area/space)
"Rm" = (/turf/shuttle/wall/science{icon_state = "9,7"},/area/space)
"Rv" = (/turf/shuttle/wall/science{icon_state = "4,13"},/area/space)
"Rx" = (/obj/structure/shuttle_part/science{icon_state = "12,0"},/turf/template_noop,/area/space)
"RT" = (/turf/shuttle/wall/science{icon_state = "7,10"},/area/space)
"Sc" = (/turf/shuttle/wall/science{icon_state = "10,1"},/area/space)
"Sh" = (/obj/structure/shuttle_part/science{icon_state = "13,11"},/turf/template_noop,/area/space)
"SI" = (/obj/structure/shuttle_part/science{icon_state = "4,0"},/turf/template_noop,/area/space)
"SW" = (/obj/machinery/light/small{dir = 8},/obj/machinery/atmospherics/pipe/simple/hidden/supply,/turf/shuttle/floor/science{icon_state = "8,2"},/area/space)
"Td" = (/turf/shuttle/wall/science{icon_state = "14,4"},/area/space)
"Tj" = (/obj/machinery/sleeper{dir = 8},/turf/shuttle/floor/science{icon_state = "11,11"},/area/space)
"Tl" = (/obj/structure/cable/yellow{d1 = 1; d2 = 2; icon_state = "1-2"},/obj/structure/cable/yellow{d1 = 1; d2 = 4; icon_state = "1-4"},/obj/machinery/light/small{dir = 8},/turf/shuttle/floor/science{icon_state = "3,3"},/area/space)
"Tu" = (/turf/shuttle/wall/science{icon_state = "11,13"},/area/space)
"Uf" = (/turf/shuttle/wall/science{icon_state = "7,7"},/area/space)
"Uv" = (/obj/machinery/power/terminal{dir = 1},/obj/structure/cable/yellow{d2 = 2; icon_state = "0-2"},/turf/floor,/area/space)
"Uw" = (/turf/shuttle/wall/science{icon_state = "11,2"},/area/space)
"UB" = (/turf/shuttle/wall/science{icon_state = "2,3"},/area/space)
"UF" = (/obj/machinery/atmospherics/unary/vent_pump/on,/obj/machinery/camera/network/research_outpost,/turf/shuttle/floor/science{icon_state = "6,5"},/area/space)
"UJ" = (/obj/machinery/atmospherics/pipe/simple/hidden/supply,/obj/machinery/light/small{dir = 8},/turf/shuttle/floor/science{icon_state = "8,9"},/area/space)
"UU" = (/obj/structure/shuttle_part/science{icon_state = "9,20"},/turf/template_noop,/area/space)
"UY" = (/turf/shuttle/floor/science{icon_state = "12,4"},/area/space)
"Vm" = (/obj/structure/shuttle_part/science{icon_state = "7,21"},/turf/template_noop,/area/space)
"VI" = (/obj/structure/shuttle_part/science{icon_state = "10,0"},/turf/template_noop,/area/space)
"VO" = (/obj/structure/shuttle_part/science{icon_state = "1,2"},/turf/template_noop,/area/space)
"VV" = (/obj/item/tool/pickaxe/excavation,/obj/item/tool/pickaxe,/obj/item/tool/wrench,/obj/item/device/measuring_tape,/obj/item/stack/flag/green,/obj/structure/table/steel,/turf/shuttle/floor/science{icon_state = "13,4"},/area/space)
"Wq" = (/turf/shuttle/wall/science{icon_state = "12,6"},/area/space)
"Wz" = (/obj/machinery/atmospherics/pipe/simple/hidden/supply,/turf/shuttle/floor/science{icon_state = "8,7"},/area/space)
"Xd" = (/obj/structure/bed/padded,/obj/item/bedsheet,/obj/machinery/camera/network/research_outpost,/turf/shuttle/floor/science{icon_state = "10,15"},/area/space)
"Xh" = (/obj/item/tool/pickaxe/excavation,/obj/item/tool/pickaxe,/obj/item/tool/wrench,/obj/item/device/measuring_tape,/obj/item/stack/flag/green,/obj/structure/table/steel,/turf/shuttle/floor/science{icon_state = "13,5"},/area/space)
"Xu" = (/obj/structure/shuttle_part/science{icon_state = "1,1"},/turf/template_noop,/area/space)
"Xv" = (/obj/structure/shuttle_part/science{icon_state = "15,4"},/turf/template_noop,/area/space)
"Xw" = (/turf/shuttle/wall/science{icon_state = "3,7"},/area/space)
"XD" = (/obj/structure/shuttle_part/science{icon_state = "1,6"},/turf/template_noop,/area/space)
"XS" = (/obj/structure/shuttle_part/science{icon_state = "1,7"},/turf/template_noop,/area/space)
"Yx" = (/turf/shuttle/wall/science{icon_state = "7,3"},/area/space)
"Yz" = (/turf/shuttle/wall/science{icon_state = "7,19"; opacity = 0},/area/space)
"YR" = (/obj/machinery/access_button{command = "cycle_exterior"; frequency = 1380; master_tag = "vasiliy_dokuchaev_shuttle"; name = "exterior access button"; pixel_y = 25; req_one_access = list(5)},/turf/shuttle/floor/science{icon_state = "4,12"},/area/space)
"Zb" = (/turf/shuttle/wall/science{icon_state = "2,2"},/area/space)
"Zy" = (/turf/shuttle/wall/science{icon_state = "7,9"},/area/space)
"ZC" = (/obj/structure/shuttle_part/science{icon_state = "8,20"},/turf/template_noop,/area/space)
"ZD" = (/obj/structure/shuttle_part/science{icon_state = "15,1"},/turf/template_noop,/area/space)
"ZT" = (/obj/machinery/atmospherics/pipe/simple/hidden/supply,/turf/shuttle/floor/science{icon_state = "8,5"},/area/space)

(1,1,1) = {"
ODODODODODODVmurLcODODODODODOD
ODODODODODqLxEZCUUQhODODODODOD
ODODODODODIGYzKOuAOrODODODODOD
ODODODODODsyEkdFukfOODODODODOD
ODODODLmwDpncIlijFicHvaWODODOD
ODODODdfpFmbIOtqwBOCJZOXODODOD
ODODODnGntkTjTDsAEXdEblLODODOD
ODODODEpQwLFsIsdIRBbIVkWODODOD
ODODODRvgpJireIZoVbzTuznODODOD
ODODODYRuyizeZovBZbKdGqrCYODOD
ODODODvtNCebvnaShIrATjiXShODOD
ODODODQyMdAdRTDfHgdRlzCAxUdZOD
ODkPIApwhqymZyUJapMNbdnsDHxjOD
JdpGuOrroMRgelBRaYxDpvbrfMjExR
XSmhXwftivQsUfWzRmajgWsKddLBoE
XDgyHpDlnMJVvDJQiuPqixWqBXnFCO
CvBPEMynclUFyxZTyYnHQvOOXhCiHx
JpumUviqcMFTCxglBQcXpxUYVVTdXv
HWUBTlbmexNMYxdkfrFBEPIidsRipU
VOZbozozeovEFjSWMzrQUwHtpPGGer
XuIlPIsEQVtiiLGTmsScQOahzSzfZD
DmhBEeSIJaCHxTcoHuVIbIRxCGPnGi
"}
