"aa" = (/turf/template_noop,/area/template_noop)
"ab" = (/obj/structure/lattice,/turf/template_noop,/area/template_noop)
"ac" = (/obj/structure/railing,/turf/template_noop,/area/template_noop)
"ad" = (/obj/effect/window_lwall_spawn/smartspawn,/turf/simulated/floor/plating,/area/template_noop)
"ae" = (/obj/spawner/structures/common/low_chance,/turf/simulated/floor/plating/under,/area/template_noop)
"af" = (/turf/simulated/floor/plating/under,/area/template_noop)
"ag" = (/obj/machinery/door/airlock/maintenance_common{name = "Service Maintenance"; req_access = list(12)},/turf/simulated/floor/tiled/techmaint_cargo,/area/template_noop)
"ah" = (/obj/effect/decal/cleanable/dirt,/turf/simulated/floor/plating/under,/area/template_noop)
"ai" = (/obj/spawner/junk/low_chance,/turf/simulated/floor/plating/under,/area/template_noop)
"aj" = (/obj/machinery/light/small,/turf/simulated/floor/plating/under,/area/template_noop)
"ak" = (/turf/simulated/wall/r_wall,/area/template_noop)
"al" = (/obj/spawner/electronics/low_chance,/obj/spawner/junkfood/rotten,/obj/spawner/junkfood/rotten,/obj/spawner/junkfood/rotten,/obj/spawner/junk/low_chance,/turf/simulated/floor/tiled/techmaint,/area/template_noop)
"am" = (/turf/simulated/floor/tiled/techmaint,/area/template_noop)
"an" = (/turf/simulated/wall,/area/template_noop)
"ao" = (/obj/spawner/scrap/sparse,/turf/simulated/floor/plating/under,/area/template_noop)
"ap" = (/mob/living/simple_animal/hostile/carp,/turf/simulated/floor/tiled/techmaint,/area/template_noop)
"aq" = (/obj/spawner/scrap/sparse/low_chance,/turf/simulated/floor/plating/under,/area/template_noop)
"ar" = (/mob/living/simple_animal/hostile/carp,/turf/template_noop,/area/template_noop)
"as" = (/obj/spawner/scrap/sparse,/turf/simulated/floor/tiled/techmaint,/area/template_noop)
"at" = (/obj/structure/railing{dir = 4; tag = "icon-railing0 (EAST)"},/turf/template_noop,/area/template_noop)
"au" = (/obj/structure/railing{dir = 4; tag = "icon-railing0 (EAST)"},/obj/structure/railing,/turf/template_noop,/area/template_noop)
"av" = (/obj/spawner/pack/machine,/obj/spawner/pack/tech_loot/low_chance,/obj/spawner/pack/tech_loot/low_chance,/turf/simulated/floor/plating/under,/area/template_noop)
"aw" = (/obj/spawner/pack/machine,/obj/spawner/booze/low_chance,/obj/spawner/booze/low_chance,/turf/simulated/floor/plating/under,/area/template_noop)
"ax" = (/obj/spawner/pack/machine,/turf/simulated/floor/tiled/techmaint_panels,/area/template_noop)
"ay" = (/obj/machinery/light/small,/obj/spawner/scrap/sparse,/turf/simulated/floor/tiled/techmaint,/area/template_noop)
"az" = (/obj/spawner/traps,/turf/simulated/floor/tiled/techmaint,/area/template_noop)
"aA" = (/mob/living/simple_animal/hostile/bear,/turf/simulated/floor/plating/under,/area/template_noop)
"aB" = (/obj/spawner/scrap/dense,/turf/simulated/floor/tiled/techmaint,/area/template_noop)
"aC" = (/obj/structure/table/rack,/obj/spawner/contraband/low_chance,/obj/spawner/tank,/obj/spawner/tank,/turf/simulated/floor/plating/under,/area/template_noop)
"aD" = (/obj/spawner/pack/machine,/turf/simulated/floor/plating/under,/area/template_noop)
"aE" = (/obj/machinery/light/small{dir = 1},/obj/spawner/pack/machine,/turf/simulated/floor/plating/under,/area/template_noop)
"aF" = (/turf/simulated/floor/tiled/steel,/area/template_noop)
"aG" = (/obj/machinery/light/small{dir = 8},/turf/simulated/floor/plating/under,/area/template_noop)
"aH" = (/obj/machinery/light/small{dir = 1},/turf/simulated/floor/plating/under,/area/template_noop)
"aI" = (/obj/structure/table/rack,/obj/spawner/pack/tech_loot,/obj/spawner/pack/tech_loot,/obj/spawner/pack/tech_loot,/obj/spawner/pack/tech_loot,/turf/simulated/floor/tiled/techmaint_panels,/area/template_noop)
"aJ" = (/obj/spawner/junk/low_chance,/obj/machinery/light/small,/turf/simulated/floor/plating/under,/area/template_noop)
"aK" = (/obj/structure/table/rack/shelf,/obj/spawner/lowkeyrandom/low_chance,/obj/spawner/lowkeyrandom/low_chance,/obj/spawner/pack/tech_loot/low_chance,/obj/spawner/pack/tech_loot/low_chance,/turf/simulated/floor/tiled/techmaint,/area/template_noop)
"aL" = (/obj/machinery/light/small{dir = 1},/obj/spawner/scrap/dense,/turf/simulated/floor/plating/under,/area/template_noop)
"aM" = (/obj/structure/catwalk,/obj/structure/cable/green{d1 = 2; d2 = 4; icon_state = "2-4"},/turf/simulated/floor/plating/under,/area/template_noop)
"aN" = (/obj/machinery/door/firedoor,/obj/machinery/door/airlock/maintenance_medical{name = "Chemistry Maintenance"; req_access = list(33)},/obj/machinery/door/blast/regular{density = 0; icon_state = "pdoor0"; id = "MedbayTotalLockdown"; layer = 2.6; name = "Medbay Total Lockdown"; opacity = 0},/obj/structure/cable/green{d1 = 4; d2 = 8; icon_state = "4-8"},/turf/simulated/floor/tiled/techmaint_cargo,/area/template_noop)
"aO" = (/obj/structure/railing{dir = 1; tag = "icon-railing0 (NORTH)"},/turf/template_noop,/area/template_noop)
"aP" = (/obj/structure/cable/green{d1 = 2; d2 = 4; icon_state = "2-4"},/obj/structure/catwalk,/turf/simulated/floor/plating/under,/area/template_noop)
"aQ" = (/obj/machinery/door/airlock/maintenance_common{name = "Service Maintenance"; req_access = list(12)},/obj/structure/cable/green{d1 = 4; d2 = 8; icon_state = "4-8"},/turf/simulated/floor/tiled/techmaint_cargo,/area/template_noop)
"aR" = (/obj/structure/cable/green{d1 = 4; d2 = 8; icon_state = "4-8"},/obj/structure/catwalk,/turf/simulated/floor/plating/under,/area/template_noop)
"aS" = (/obj/machinery/light/small{dir = 1},/obj/structure/cable/green{d1 = 4; d2 = 8; icon_state = "4-8"},/obj/structure/catwalk,/turf/simulated/floor/plating/under,/area/template_noop)
"aT" = (/obj/spawner/junk/low_chance,/obj/structure/catwalk,/obj/structure/cable/green{d1 = 1; d2 = 8; icon_state = "1-8"},/turf/simulated/floor/plating/under,/area/template_noop)
"aU" = (/obj/spawner/junk/low_chance,/turf/simulated/floor/tiled/techmaint,/area/template_noop)
"aV" = (/obj/spawner/junk/low_chance,/turf/simulated/floor/tiled/steel,/area/template_noop)
"aW" = (/obj/machinery/light/small{dir = 1},/obj/structure/cable/green{d2 = 4; icon_state = "0-4"},/obj/structure/catwalk,/turf/simulated/floor/plating/under,/area/template_noop)
"aX" = (/obj/structure/girder,/turf/simulated/floor/plating/under,/area/template_noop)
"aY" = (/obj/spawner/scrap/dense,/turf/simulated/floor/tiled/steel/gray_platform,/area/template_noop)
"aZ" = (/obj/spawner/junk/low_chance,/obj/structure/cable/green{d1 = 1; d2 = 2; icon_state = "1-2"},/obj/structure/catwalk,/turf/simulated/floor/plating/under,/area/template_noop)
"ba" = (/obj/structure/table/rack,/obj/spawner/pack/tech_loot,/obj/spawner/boxes,/turf/simulated/floor/tiled/steel/gray_platform,/area/template_noop)
"bb" = (/mob/living/simple_animal/hostile/carp,/turf/simulated/floor/tiled/steel,/area/template_noop)
"bc" = (/obj/spawner/scrap/sparse,/turf/simulated/floor/tiled/steel/gray_platform,/area/template_noop)
"be" = (/obj/structure/cable/green{d1 = 1; d2 = 8; icon_state = "1-8"},/obj/structure/catwalk,/mob/living/simple_animal/hostile/carp,/turf/simulated/floor/plating/under,/area/template_noop)
"bf" = (/obj/structure/table/rack,/obj/spawner/pack/tech_loot,/obj/spawner/pack/tech_loot,/obj/spawner/boxes,/turf/simulated/floor/plating/under,/area/template_noop)
"bg" = (/obj/spawner/pack/machine,/turf/simulated/floor/tiled/steel/gray_platform,/area/template_noop)
"bh" = (/obj/spawner/pack/tech_loot,/obj/spawner/pack/tech_loot,/obj/structure/table/rack,/turf/simulated/floor/plating/under,/area/template_noop)
"bi" = (/obj/machinery/door/firedoor,/obj/effect/window_lwall_spawn/smartspawn,/turf/simulated/floor/plating,/area/template_noop)
"bj" = (/obj/structure/table/standard,/obj/item/weapon/folder/blue,/obj/item/weapon/hand_labeler,/obj/spawner/pack/tech_loot,/obj/spawner/pack/tech_loot,/turf/simulated/floor/tiled/steel/gray_platform,/area/template_noop)
"tL" = (/obj/effect/decal/cleanable/blood/oil,/turf/simulated/floor/plating/under,/area/template_noop)

(1,1,1) = {"
aaaaaaaaaaaaaaaXaaaaaaaaaaaaaaaaaaaaaaaaaaaaaaaaaa
aaaaaaaaaaaaabaXababaXaaaaacacacaaaaaaaaaaaaaaabab
aaabaaaaaaababadaeafagababahafafafafaiahajafababaf
aaafaaabababaaakalamanabaaafananadadanaganadadanaX
abaXaoababababakakapanaaaaafanaqafaaaaabaaaraaabaX
afaXabaaaaaaababakasanaaatafanaqafaaaaababaaababaX
aaaaabaaaaaaaaabakafanaaatamanananananagaXanabanan
aaaaaaaaaaaaaaaXaXafanacauamanaoavawanamaxanananab
aaaaaaaaaaaaaaababafanayazamagaAababanamasanaBanab
aaaaaaaaaaaaaaaaabaXakakagakakanaoaCanamamanamanan
aaaaaaaaaaaXaXakanakaDaEafaiaBanananaXaGafagafaiab
aaaaaaaaaaaHaiafafaiafababafaIanabaaaaababananaGab
aaaaaaaaaaaiafafaJafabababafaIaXaaaaaaaaabaxanafab
aaaaaaaaaaaXakakaXabaiajafaiaiaaafaaabafafapanafan
abaaaaaaaaaaabababaaaXakaganabaaaaabaoaoaxaKanafan
abakaXababaXaaabababakaLafaXaaaaaaaXanananaXaXaMaN
abakafafafakakakakakakaOaOaaaaabaXaPaQaRaSababaTaX
abaXaUaxapagaVaVaFaYanaaaaaaaXananaZadaOaOaaaaaaaa
aaaXakakakakbaafbbbcadaaaaaiamaWaQbeakaaaaaaaaaaaa
aaaaabaaaaakbfafafbgadaaaaafafbhaXakakakbibiaXaXaa
aaaaabababaXababafbjanaaaaaaaOaOaXababaaaaabaaabab
abaXaUamababaaabaXaXaXaaaaaaaaaaaXababaaaaaaabafab
abaktLafaaaaaaabababaaaaaaaaaaaaaaaaabaaababaXaXaf
afaXaXabaaaaaaaaaaaaaaaaaaaaaaaaaaaaaaaaaaaaabaXab
ababaaaaaaaaaaaaaaaaaaaaaaaaaaaaaaaaaaaaaaaaaaabaa
"}
