//MAP CONVERTED BY dmm2tgm.py THIS HEADER COMMENT PREVENTS RECONVERSION, DO NOT REMOVE
"aa" = (
/turf/template_noop,
/area/template_noop)
"ad" = (
/obj/spawner/pack/machine,
/turf/simulated/floor/tiled/dark/danger,
/area/template_noop)
"ae" = (
/obj/structure/girder,
/turf/simulated/floor/plating/under,
/area/template_noop)
"af" = (
/obj/spawner/lowkeyrandom/low_chance,
/obj/spawner/lowkeyrandom/low_chance,
/turf/simulated/floor/tiled/techmaint,
/area/template_noop)
"ag" = (
/obj/spawner/pack/machine,
/turf/simulated/floor/tiled/techmaint,
/area/template_noop)
"ah" = (
/obj/spawner/junkfood/rotten,
/turf/simulated/floor/tiled/dark/danger,
/area/template_noop)
"an" = (
/obj/spawner/scrap/sparse/low_chance,
/turf/simulated/floor/plating/under,
/area/template_noop)
"ap" = (
/obj/machinery/camera/network/engineering{
	dir = 1
	},
/turf/simulated/floor/plating/under,
/area/template_noop)
"aq" = (
/obj/spawner/junk,
/turf/simulated/floor/plating/under,
/area/template_noop)
"ar" = (
/obj/spawner/scrap/dense,
/turf/simulated/floor/plating/under,
/area/template_noop)
"as" = (
/obj/spawner/junkfood/rotten,
/turf/simulated/floor/plating/under,
/area/template_noop)
"at" = (
/obj/spawner/scrap/dense,
/turf/simulated/floor/tiled/techmaint,
/area/template_noop)
"az" = (
/obj/machinery/camera/network/engineering{
	dir = 1
	},
/obj/spawner/junk,
/turf/simulated/floor/tiled/dark/danger,
/area/template_noop)
"aA" = (
/turf/simulated/wall/r_wall,
/area/template_noop)
"aC" = (
/obj/spawner/junk,
/turf/simulated/floor/tiled/dark/danger,
/area/template_noop)
"aE" = (
/mob/living/simple_animal/hostile/carp,
/turf/simulated/floor/tiled/dark/danger,
/area/template_noop)
"aI" = (
/obj/machinery/light/small{
	dir = 1
	},
/turf/simulated/floor/plating/under,
/area/template_noop)
"aJ" = (
/obj/spawner/scrap/sparse,
/turf/simulated/floor/plating/under,
/area/template_noop)
"aP" = (
/mob/living/simple_animal/hostile/bear,
/turf/simulated/floor/tiled/techmaint,
/area/template_noop)
"aQ" = (
/obj/structure/lattice,
/obj/spawner/junk,
/turf/template_noop,
/area/template_noop)
"aR" = (
/mob/living/simple_animal/hostile/carp,
/turf/template_noop,
/area/template_noop)
"aZ" = (
/turf/simulated/floor/tiled/dark/danger,
/area/template_noop)
"bb" = (
/obj/machinery/light/small,
/turf/simulated/floor/plating/under,
/area/template_noop)
"bd" = (
/obj/machinery/door/firedoor,
/obj/effect/window_lwall_spawn/smartspawn,
/turf/simulated/floor/plating,
/area/template_noop)
"bf" = (
/mob/living/simple_animal/hostile/carp,
/turf/simulated/floor/tiled/techmaint,
/area/template_noop)
"bg" = (
/obj/structure/extinguisher_cabinet{
	pixel_y = 27
	},
/turf/simulated/floor/plating/under,
/area/template_noop)
"bh" = (
/obj/structure/railing{
	dir = 1;
	tag = "icon-railing0 (NORTH)"
	},
/obj/spawner/junkfood/rotten,
/turf/simulated/floor/plating/under,
/area/template_noop)
"bi" = (
/obj/spawner/traps,
/turf/simulated/floor/tiled/techmaint,
/area/template_noop)
"bl" = (
/obj/structure/sign/atmos_co2{
	pixel_y = 32
	},
/turf/simulated/floor/plating/under,
/area/template_noop)
"bn" = (
/obj/structure/lattice,
/turf/template_noop,
/area/template_noop)
"bo" = (
/obj/spawner/junk/low_chance,
/turf/simulated/floor/plating/under,
/area/template_noop)
"bp" = (
/obj/structure/table/reinforced,
/obj/item/stack/material/glass{
	amount = 120
	},
/obj/spawner/junk,
/turf/simulated/floor/tiled/dark/techfloor_grid,
/area/template_noop)
"bq" = (
/obj/structure/table/reinforced,
/obj/item/stack/material/steel{
	amount = 120
	},
/obj/spawner/junk,
/turf/simulated/floor/tiled/dark/techfloor_grid,
/area/template_noop)
"br" = (
/obj/structure/table/reinforced,
/obj/item/tank/emergency_oxygen{
	pixel_x = -8
	},
/obj/item/tank/emergency_oxygen{
	pixel_x = -8
	},
/obj/item/clothing/mask/breath{
	pixel_x = 4
	},
/obj/item/clothing/mask/breath{
	pixel_x = 4
	},
/obj/spawner/junk,
/turf/simulated/floor/tiled/dark/techfloor_grid,
/area/template_noop)
"bs" = (
/obj/machinery/door/firedoor,
/obj/machinery/door/airlock/engineering{
	name = "Wasting Room"
	},
/turf/simulated/floor/tiled/dark/techfloor_grid,
/area/template_noop)
"bt" = (
/turf/simulated/floor/tiled/techmaint,
/area/template_noop)
"bw" = (
/obj/machinery/door/firedoor,
/obj/effect/window_lwall_spawn/plasma,
/turf/simulated/floor/plating,
/area/template_noop)
"bx" = (
/turf/simulated/floor/plating/under,
/area/template_noop)
"by" = (
/obj/structure/table/reinforced,
/obj/item/tank/emergency_oxygen/double,
/obj/machinery/light/small,
/turf/simulated/floor/plating/under,
/area/template_noop)
"bz" = (
/obj/structure/cable/green{
	d1 = 1;
	d2 = 2;
	icon_state = "1-2"
	},
/turf/simulated/floor/plating/under,
/area/template_noop)
"bA" = (
/obj/structure/railing{
	dir = 8;
	tag = "icon-railing0 (WEST)"
	},
/turf/simulated/floor/plating/under,
/area/template_noop)
"bB" = (
/obj/structure/catwalk,
/obj/structure/cable/green{
	d2 = 2;
	icon_state = "0-2"
	},
/turf/simulated/floor/plating/under,
/area/template_noop)
"bC" = (
/obj/effect/window_lwall_spawn/smartspawn,
/turf/simulated/floor/plating/under,
/area/template_noop)
"bD" = (
/obj/structure/railing{
	dir = 1;
	tag = "icon-railing0 (NORTH)"
	},
/obj/structure/cable/green{
	d1 = 4;
	d2 = 8;
	icon_state = "4-8"
	},
/turf/simulated/floor/plating/under,
/area/template_noop)
"bK" = (
/obj/structure/catwalk,
/obj/structure/sign/atmos_co2{
	pixel_y = 32
	},
/turf/simulated/floor/plating/under,
/area/template_noop)
"bS" = (
/obj/spawner/junk/low_chance,
/turf/simulated/floor/plating,
/area/template_noop)
"bW" = (
/obj/machinery/door/airlock/maintenance_engineering{
	name = "Engineering Maintenance";
	req_access = list(10)
	},
/turf/simulated/floor/tiled/techmaint_cargo,
/area/template_noop)
"bX" = (
/obj/structure/catwalk,
/obj/structure/sign/atmos_o2{
	pixel_x = -32
	},
/turf/simulated/floor/plating/under,
/area/template_noop)
"ca" = (
/obj/spawner/junk/low_chance,
/turf/simulated/floor/tiled/techmaint,
/area/template_noop)
"cc" = (
/obj/machinery/firealarm{
	pixel_y = 28
	},
/turf/simulated/floor/tiled/dark/techfloor,
/area/template_noop)
"ci" = (
/obj/machinery/door/firedoor,
/obj/machinery/door/airlock/maintenance_engineering{
	name = "Atmospherics Maintenance";
	req_access = list(24)
	},
/turf/simulated/floor/tiled/techmaint_cargo,
/area/template_noop)
"ck" = (
/turf/simulated/floor/tiled/dark/techfloor,
/area/template_noop)
"cn" = (
/obj/spawner/pack/machine,
/turf/simulated/floor/tiled/techmaint_panels,
/area/template_noop)
"cp" = (
/obj/structure/table/rack,
/obj/spawner/lowkeyrandom,
/turf/simulated/floor/tiled/techmaint,
/area/template_noop)
"cv" = (
/obj/machinery/light/small{
	dir = 1
	},
/turf/simulated/floor/tiled/techmaint,
/area/template_noop)
"cx" = (
/obj/machinery/camera/network/engineering,
/turf/simulated/floor/tiled/techmaint,
/area/template_noop)
"cz" = (
/obj/structure/table/reinforced,
/obj/spawner/pack/tech_loot,
/obj/spawner/pack/tech_loot,
/obj/spawner/pack/tech_loot,
/obj/spawner/pack/tech_loot,
/turf/simulated/floor/tiled/techmaint,
/area/template_noop)
"cA" = (
/obj/effect/decal/cleanable/dirt,
/obj/structure/table/reinforced,
/obj/spawner/tank,
/turf/simulated/floor/tiled/techmaint,
/area/template_noop)
"cB" = (
/obj/machinery/door/firedoor,
/obj/machinery/door/airlock/maintenance_engineering{
	name = "Atmospherics Maintenance";
	req_access = list(24)
	},
/obj/structure/cable/green{
	d1 = 1;
	d2 = 2;
	icon_state = "1-2"
	},
/turf/simulated/floor/tiled/techmaint_cargo,
/area/template_noop)
"cE" = (
/obj/structure/railing{
	dir = 1;
	tag = "icon-railing0 (NORTH)"
	},
/obj/structure/cable/green{
	d1 = 4;
	d2 = 8;
	icon_state = "4-8"
	},
/obj/spawner/powercell/low_chance,
/turf/simulated/floor/plating/under,
/area/template_noop)
"cF" = (
/obj/structure/railing{
	dir = 4;
	tag = "icon-railing0 (EAST)"
	},
/obj/structure/railing{
	dir = 1;
	tag = "icon-railing0 (NORTH)"
	},
/obj/structure/cable/green{
	d1 = 4;
	d2 = 8;
	icon_state = "4-8"
	},
/obj/spawner/traps/wire_splicing/low_chance,
/turf/simulated/floor/plating/under,
/area/template_noop)
"cG" = (
/obj/structure/catwalk,
/obj/structure/cable/green{
	d1 = 1;
	d2 = 4;
	icon_state = "1-4"
	},
/obj/structure/cable/green{
	d1 = 4;
	d2 = 8;
	icon_state = "4-8"
	},
/turf/simulated/floor/plating/under,
/area/template_noop)
"cH" = (
/obj/structure/catwalk,
/obj/structure/cable/green{
	d1 = 4;
	d2 = 8;
	icon_state = "4-8"
	},
/turf/simulated/floor/plating/under,
/area/template_noop)
"cI" = (
/obj/structure/railing,
/obj/structure/railing{
	dir = 8;
	tag = "icon-railing0 (WEST)"
	},
/obj/structure/railing{
	dir = 4;
	tag = "icon-railing0 (EAST)"
	},
/obj/structure/cable/green{
	d1 = 4;
	d2 = 8;
	icon_state = "4-8"
	},
/turf/simulated/floor/plating/under,
/area/template_noop)
"cJ" = (
/obj/structure/railing{
	dir = 8;
	tag = "icon-railing0 (WEST)"
	},
/obj/structure/railing,
/obj/structure/cable/green{
	d1 = 4;
	d2 = 8;
	icon_state = "4-8"
	},
/turf/simulated/floor/plating/under,
/area/template_noop)
"cL" = (
/obj/structure/railing,
/obj/structure/cable/green{
	d1 = 4;
	d2 = 8;
	icon_state = "4-8"
	},
/turf/simulated/floor/plating/under,
/area/template_noop)
"cM" = (
/obj/structure/railing,
/obj/structure/cable/green{
	d1 = 2;
	d2 = 8;
	icon_state = "2-8"
	},
/obj/structure/cable/green{
	d1 = 2;
	d2 = 4;
	icon_state = "2-4"
	},
/turf/simulated/floor/plating/under,
/area/template_noop)
"cO" = (
/obj/structure/cable/green{
	d1 = 4;
	d2 = 8;
	icon_state = "4-8"
	},
/turf/simulated/floor/plating/under,
/area/template_noop)
"cP" = (
/obj/structure/railing{
	dir = 4;
	tag = "icon-railing0 (EAST)"
	},
/obj/structure/cable/green{
	d1 = 4;
	d2 = 8;
	icon_state = "4-8"
	},
/obj/spawner/traps/wire_splicing/low_chance,
/turf/simulated/floor/plating/under,
/area/template_noop)
"cQ" = (
/obj/structure/catwalk,
/obj/structure/cable/green{
	d1 = 1;
	d2 = 8;
	icon_state = "1-8"
	},
/turf/simulated/floor/plating/under,
/area/template_noop)
"cT" = (
/obj/structure/railing,
/turf/simulated/floor/plating/under,
/area/template_noop)
"cV" = (
/obj/structure/catwalk,
/obj/machinery/light/small,
/turf/simulated/floor/plating/under,
/area/template_noop)
"cW" = (
/obj/structure/catwalk,
/turf/simulated/floor/plating/under,
/area/template_noop)
"cX" = (
/obj/structure/catwalk,
/obj/structure/cable/green{
	d1 = 1;
	d2 = 2;
	icon_state = "1-2"
	},
/turf/simulated/floor/plating/under,
/area/template_noop)
"cY" = (
/obj/structure/railing,
/obj/structure/railing{
	dir = 8;
	tag = "icon-railing0 (WEST)"
	},
/turf/simulated/floor/plating/under,
/area/template_noop)
"cZ" = (
/obj/structure/railing,
/obj/structure/railing{
	dir = 4;
	tag = "icon-railing0 (EAST)"
	},
/turf/simulated/floor/plating/under,
/area/template_noop)
"db" = (
/obj/structure/sign/vacuum,
/turf/simulated/wall/r_wall,
/area/template_noop)
"dc" = (
/obj/machinery/door/airlock/external{
	frequency = 1379;
	icon_state = "door_locked";
	id_tag = "atmos_airlock_door_int";
	locked = 1;
	name = "Internal Atmospherics Airlock"
	},
/turf/simulated/floor/tiled/steel/cargo,
/area/template_noop)
"dd" = (
/obj/structure/railing{
	dir = 1;
	tag = "icon-railing0 (NORTH)"
	},
/turf/simulated/floor/plating/under,
/area/template_noop)
"de" = (
/obj/structure/cable/green{
	d1 = 1;
	d2 = 2;
	icon_state = "1-2"
	},
/obj/structure/railing{
	dir = 1;
	tag = "icon-railing0 (NORTH)"
	},
/turf/simulated/floor/plating/under,
/area/template_noop)
"df" = (
/obj/effect/decal/cleanable/dirt,
/obj/structure/table/rack,
/obj/spawner/pack/tech_loot,
/obj/spawner/pack/tech_loot,
/turf/simulated/floor/tiled/techmaint,
/area/template_noop)
"dh" = (
/turf/simulated/wall,
/area/template_noop)
"di" = (
/obj/spawner/lowkeyrandom,
/turf/simulated/floor/plating,
/area/template_noop)
"dj" = (
/obj/effect/window_lwall_spawn/smartspawn,
/turf/simulated/floor/plating,
/area/template_noop)
"dk" = (
/obj/structure/cable/green{
	d1 = 1;
	d2 = 2;
	icon_state = "1-2"
	},
/obj/effect/window_lwall_spawn/smartspawn,
/turf/simulated/floor/plating,
/area/template_noop)
"NP" = (
/obj/spawner/scrap/dense,
/turf/simulated/floor/tiled/steel/cargo,
/area/template_noop)

(1,1,1) = {"
bn
bx
ae
aa
aa
aa
bn
bn
bn
ae
aa
aa
aa
aa
aa
aa
aa
aa
bn
aa
aa
aa
bx
ae
bn
"}
(2,1,1) = {"
bn
NP
bn
aa
aa
aA
aA
bs
aA
aA
bn
aa
aa
bn
bn
aA
aA
aA
aA
aa
aa
bn
bn
bx
bx
"}
(3,1,1) = {"
bx
bt
ae
bx
aa
aA
cT
bt
aP
aA
aA
aA
bn
aA
aA
aA
ar
aq
aA
aA
bn
bn
aa
aa
aa
"}
(4,1,1) = {"
bn
bx
bx
ae
bn
aA
bl
aA
bA
aA
at
aA
ae
aA
cn
bt
bD
cT
bt
dj
aa
aa
aa
aa
aa
"}
(5,1,1) = {"
aa
bn
bx
bd
aa
bd
an
bx
bx
aA
af
bW
bf
aA
cn
bt
cE
cT
bt
dj
aa
aa
aa
aa
aa
"}
(6,1,1) = {"
bn
bx
ap
aA
bn
aA
aA
aA
bx
aA
aA
aA
bt
aA
aA
cv
cF
cZ
ca
aA
aa
aa
aa
aa
aa
"}
(7,1,1) = {"
bn
bx
bo
aA
aa
bn
bn
aA
aq
aA
bS
aA
cW
bh
aA
bB
cG
cW
bt
aA
aa
aa
aa
aa
aa
"}
(8,1,1) = {"
bn
bx
bx
bd
aa
bn
bn
aA
ar
as
bx
cT
cW
aA
aA
cx
cH
cW
ag
aA
aa
aa
aa
aa
aa
"}
(9,1,1) = {"
ae
bx
bx
aA
aA
aA
aA
aA
aA
aA
ae
aA
cW
aA
cn
ca
cH
cW
bt
dj
aa
aa
aa
aa
aa
"}
(10,1,1) = {"
aa
bx
bx
aZ
aZ
bd
bn
bw
aQ
bn
bn
aA
bK
aA
cn
aP
cH
cW
ca
dj
bn
aa
aa
aa
aa
"}
(11,1,1) = {"
aa
bx
bx
ad
aE
bd
bn
bw
bn
aa
aa
ae
bn
aA
aA
cz
cH
cW
bt
aA
aA
aa
aa
aa
aa
"}
(12,1,1) = {"
bn
bx
bx
aZ
aZ
bd
bn
bw
bn
bn
aa
aa
aa
ar
aA
cA
cH
cW
bt
df
aA
bn
bn
aa
aa
"}
(13,1,1) = {"
aa
bx
bx
aZ
dj
aA
aA
aA
ae
bx
aa
aa
aa
ae
aA
aA
cI
cW
db
aA
aA
ae
bn
aa
aa
"}
(14,1,1) = {"
bn
bx
bx
aZ
dj
bx
bx
bn
ae
bx
aa
aa
bn
bo
bx
bW
cH
cW
dc
bx
bx
bx
bn
aa
aa
"}
(15,1,1) = {"
aa
bn
bx
ah
dj
bn
bx
bx
aA
cW
aA
aA
aA
aA
aA
aA
cJ
cV
aA
dh
aA
ae
bn
aa
aa
"}
(16,1,1) = {"
aa
bn
bx
az
aA
ae
ar
bx
dj
cW
cW
bX
cW
bC
ar
ae
cL
cW
dj
di
aA
bn
bn
aa
aa
"}
(17,1,1) = {"
aa
bn
bx
aC
dj
bn
bx
bo
dj
bA
aA
bt
ca
aA
aA
aA
cL
cW
aA
aA
aA
aa
aa
aa
aa
"}
(18,1,1) = {"
aa
bx
bx
aZ
dj
bn
bo
bo
aA
bo
aA
bf
bt
bi
cp
aA
cL
cW
dd
dj
bn
aa
aa
aa
aa
"}
(19,1,1) = {"
aa
bx
bx
aZ
dj
aA
aA
aA
aA
aA
aA
aA
aA
ci
aA
aA
cM
cX
de
dk
bn
aa
aa
aa
aa
"}
(20,1,1) = {"
aa
bx
bx
aZ
aZ
bd
aJ
bx
bn
bn
bn
aA
ck
ck
bp
aA
cL
cW
aA
aA
aA
aA
ae
aa
aa
"}
(21,1,1) = {"
bn
bx
bx
ad
aZ
bd
bn
aa
aR
aa
bn
aA
ck
ck
bq
aA
cL
cW
bi
bW
at
aA
bn
aa
aa
"}
(22,1,1) = {"
bn
bx
bx
aZ
aZ
bd
bn
aa
aa
bn
bn
aA
cc
ck
br
aA
cO
cY
bt
aA
aA
aA
bn
aa
aa
"}
(23,1,1) = {"
aa
bn
bx
bx
aA
aA
aa
aa
aa
ae
aA
aA
bg
bx
by
aA
cP
cZ
aP
aA
bn
bn
bn
ae
bn
"}
(24,1,1) = {"
aa
bn
bx
bx
dh
aI
aa
aa
aa
bb
ae
bn
bn
bn
bz
cB
cQ
cW
bt
aA
aa
aa
bx
ae
bn
"}
(25,1,1) = {"
aa
aa
aa
bn
bn
aa
aa
aa
aa
aa
aa
aa
aa
aa
ae
aA
aA
dj
dj
aA
aa
aa
bx
ar
bn
"}
