//MAP CONVERTED BY dmm2tgm.py THIS HEADER COMMENT PREVENTS RECONVERSION, DO NOT REMOVE
"aa" = (
/turf/template_noop,
/area/template_noop)
"ab" = (
/obj/structure/lattice,
/turf/template_noop,
/area/template_noop)
"ac" = (
/obj/structure/railing,
/turf/template_noop,
/area/template_noop)
"ad" = (
/turf/wall/low/with_glass/smart,
/area/template_noop)
"ae" = (
/obj/spawner/structures/common/low_chance,
/turf/floor/plating/under/airless,
/area/template_noop)
"af" = (
/turf/floor/plating/under/airless,
/area/template_noop)
"ag" = (
/obj/machinery/door/airlock/maintenance_common{
	name = "Service Maintenance";
	req_access = list(12)
	},
/turf/floor/tiled/techmaint_cargo/airless,
/area/template_noop)
"ah" = (
/obj/effect/decal/cleanable/dirt,
/turf/floor/plating/under/airless,
/area/template_noop)
"ai" = (
/obj/spawner/junk/low_chance,
/turf/floor/plating/under/airless,
/area/template_noop)
"aj" = (
/obj/machinery/light/small,
/turf/floor/plating/under/airless,
/area/template_noop)
"ak" = (
/turf/wall/reinforced,
/area/template_noop)
"al" = (
/obj/spawner/electronics/low_chance,
/obj/spawner/junkfood/rotten,
/obj/spawner/junkfood/rotten,
/obj/spawner/junkfood/rotten,
/obj/spawner/junk/low_chance,
/turf/floor/tiled/techmaint/airless,
/area/template_noop)
"am" = (
/turf/floor/tiled/techmaint/airless,
/area/template_noop)
"an" = (
/turf/wall,
/area/template_noop)
"ao" = (
/obj/spawner/scrap/sparse,
/turf/floor/plating/under/airless,
/area/template_noop)
"ap" = (
/mob/living/simple_animal/hostile/carp,
/turf/floor/tiled/techmaint/airless,
/area/template_noop)
"aq" = (
/obj/spawner/scrap/sparse/low_chance,
/turf/floor/plating/under/airless,
/area/template_noop)
"ar" = (
/mob/living/simple_animal/hostile/carp,
/turf/template_noop,
/area/template_noop)
"as" = (
/obj/spawner/scrap/sparse,
/turf/floor/tiled/techmaint/airless,
/area/template_noop)
"at" = (
/obj/structure/railing{
	dir = 4;
	tag = "icon-railing0 (EAST)"
	},
/turf/template_noop,
/area/template_noop)
"au" = (
/obj/structure/railing{
	dir = 4;
	tag = "icon-railing0 (EAST)"
	},
/obj/structure/railing,
/turf/template_noop,
/area/template_noop)
"av" = (
/obj/spawner/pack/machine,
/obj/spawner/pack/tech_loot/low_chance,
/obj/spawner/pack/tech_loot/low_chance,
/turf/floor/plating/under/airless,
/area/template_noop)
"aw" = (
/obj/spawner/pack/machine,
/obj/spawner/booze/low_chance,
/obj/spawner/booze/low_chance,
/turf/floor/plating/under/airless,
/area/template_noop)
"ax" = (
/obj/spawner/pack/machine,
/turf/floor/tiled/techmaint_panels/airless,
/area/template_noop)
"ay" = (
/obj/machinery/light/small,
/obj/spawner/scrap/sparse,
/turf/floor/tiled/techmaint/airless,
/area/template_noop)
"az" = (
/obj/spawner/traps,
/turf/floor/tiled/techmaint/airless,
/area/template_noop)
"aA" = (
/mob/living/simple_animal/hostile/bear,
/turf/floor/plating/under/airless,
/area/template_noop)
"aB" = (
/obj/spawner/scrap/dense,
/turf/floor/tiled/techmaint/airless,
/area/template_noop)
"aC" = (
/obj/structure/table/rack,
/obj/spawner/contraband/low_chance,
/obj/spawner/tank,
/obj/spawner/tank,
/turf/floor/plating/under/airless,
/area/template_noop)
"aD" = (
/obj/spawner/pack/machine,
/turf/floor/plating/under/airless,
/area/template_noop)
"aE" = (
/obj/machinery/light/small{
	dir = 1
	},
/obj/spawner/pack/machine,
/turf/floor/plating/under/airless,
/area/template_noop)
"aF" = (
/turf/floor/tiled/steel/airless,
/area/template_noop)
"aG" = (
/obj/machinery/light/small{
	dir = 8
	},
/turf/floor/plating/under/airless,
/area/template_noop)
"aH" = (
/obj/machinery/light/small{
	dir = 1
	},
/turf/floor/plating/under/airless,
/area/template_noop)
"aI" = (
/obj/structure/table/rack,
/obj/spawner/pack/tech_loot,
/obj/spawner/pack/tech_loot,
/obj/spawner/pack/tech_loot,
/obj/spawner/pack/tech_loot,
/turf/floor/tiled/techmaint_panels/airless,
/area/template_noop)
"aJ" = (
/obj/spawner/junk/low_chance,
/obj/machinery/light/small,
/turf/floor/plating/under/airless,
/area/template_noop)
"aK" = (
/obj/structure/table/rack/shelf,
/obj/spawner/lowkeyrandom/low_chance,
/obj/spawner/lowkeyrandom/low_chance,
/obj/spawner/pack/tech_loot/low_chance,
/obj/spawner/pack/tech_loot/low_chance,
/turf/floor/tiled/techmaint/airless,
/area/template_noop)
"aL" = (
/obj/machinery/light/small{
	dir = 1
	},
/obj/spawner/scrap/dense,
/turf/floor/plating/under/airless,
/area/template_noop)
"aN" = (
/obj/machinery/door/firedoor,
/obj/machinery/door/airlock/maintenance_medical{
	name = "Chemistry Maintenance";
	req_access = list(33)
	},
/obj/machinery/door/blast/regular{
	density = 0;
	icon_state = "pdoor0";
	id = "MedbayTotalLockdown";
	layer = 2.6;
	name = "Medbay Total Lockdown";
	opacity = 0
	},
/turf/floor/tiled/techmaint_cargo/airless,
/area/template_noop)
"aO" = (
/obj/structure/railing{
	dir = 1;
	tag = "icon-railing0 (NORTH)"
	},
/turf/template_noop,
/area/template_noop)
"aR" = (
/obj/structure/catwalk,
/turf/floor/plating/under/airless,
/area/template_noop)
"aU" = (
/obj/spawner/junk/low_chance,
/turf/floor/tiled/techmaint/airless,
/area/template_noop)
"aV" = (
/obj/spawner/junk/low_chance,
/turf/floor/tiled/steel/airless,
/area/template_noop)
"aW" = (
/obj/machinery/light/small{
	dir = 1
	},
/obj/structure/catwalk,
/turf/floor/plating/under/airless,
/area/template_noop)
"aX" = (
/obj/structure/girder,
/turf/floor/plating/under/airless,
/area/template_noop)
"aY" = (
/obj/spawner/scrap/dense,
/turf/floor/tiled/steel/gray_platform/airless,
/area/template_noop)
"aZ" = (
/obj/spawner/junk/low_chance,
/obj/structure/catwalk,
/turf/floor/plating/under/airless,
/area/template_noop)
"ba" = (
/obj/structure/table/rack,
/obj/spawner/pack/tech_loot,
/obj/spawner/boxes,
/turf/floor/tiled/steel/gray_platform/airless,
/area/template_noop)
"bb" = (
/mob/living/simple_animal/hostile/carp,
/turf/floor/tiled/steel/airless,
/area/template_noop)
"bc" = (
/obj/spawner/scrap/sparse,
/turf/floor/tiled/steel/gray_platform/airless,
/area/template_noop)
"be" = (
/obj/structure/catwalk,
/mob/living/simple_animal/hostile/carp,
/turf/floor/plating/under/airless,
/area/template_noop)
"bf" = (
/obj/structure/table/rack,
/obj/spawner/pack/tech_loot,
/obj/spawner/pack/tech_loot,
/obj/spawner/boxes,
/turf/floor/plating/under/airless,
/area/template_noop)
"bg" = (
/obj/spawner/pack/machine,
/turf/floor/tiled/steel/gray_platform/airless,
/area/template_noop)
"bh" = (
/obj/spawner/pack/tech_loot,
/obj/spawner/pack/tech_loot,
/obj/structure/table/rack,
/turf/floor/plating/under/airless,
/area/template_noop)
"bi" = (
/obj/machinery/door/firedoor,
/turf/wall/low/with_glass/smart,
/area/template_noop)
"bj" = (
/obj/structure/table/standard,
/obj/item/folder/blue,
/obj/item/hand_labeler,
/obj/spawner/pack/tech_loot,
/obj/spawner/pack/tech_loot,
/turf/floor/tiled/steel/gray_platform/airless,
/area/template_noop)
"tL" = (
/obj/effect/decal/cleanable/blood/oil,
/turf/floor/plating/under/airless,
/area/template_noop)

(1,1,1) = {"
aa
aa
aa
aa
ab
af
aa
aa
aa
aa
aa
aa
aa
aa
ab
ab
ab
ab
aa
aa
aa
ab
ab
af
ab
"}
(2,1,1) = {"
aa
aa
ab
af
aX
aX
aa
aa
aa
aa
aa
aa
aa
aa
aa
ak
ak
aX
aX
aa
aa
aX
ak
aX
ab
"}
(3,1,1) = {"
aa
aa
aa
aa
ao
ab
ab
aa
aa
aa
aa
aa
aa
aa
aa
aX
af
aU
ak
ab
ab
aU
tL
aX
aa
"}
(4,1,1) = {"
aa
aa
aa
ab
ab
aa
aa
aa
aa
aa
aa
aa
aa
aa
aa
ab
af
ax
ak
aa
ab
am
af
ab
aa
"}
(5,1,1) = {"
aa
aa
aa
ab
ab
aa
aa
aa
aa
aa
aa
aa
aa
aa
aa
ab
af
ap
ak
aa
ab
ab
aa
aa
aa
"}
(6,1,1) = {"
aa
aa
ab
ab
ab
aa
aa
aa
aa
aa
aX
aH
ai
aX
aa
aX
ak
ag
ak
ak
aX
ab
aa
aa
aa
"}
(7,1,1) = {"
aa
ab
ab
aa
ab
ab
aa
aa
aa
aa
aX
ai
af
ak
ab
aa
ak
aV
ba
bf
ab
aa
aa
aa
aa
"}
(8,1,1) = {"
aX
aX
ad
ak
ak
ab
ab
aX
ab
aa
ak
af
af
ak
ab
ab
ak
aV
af
af
ab
ab
ab
aa
aa
"}
(9,1,1) = {"
aa
ab
ae
al
ak
ak
ak
aX
ab
ab
an
af
aJ
aX
ab
ab
ak
aF
bb
af
af
aX
ab
aa
aa
"}
(10,1,1) = {"
aa
ab
af
am
ap
as
af
af
af
aX
ak
ai
af
ab
aa
ab
ak
aY
bc
bg
bj
aX
ab
aa
aa
"}
(11,1,1) = {"
aa
aX
ag
an
an
an
an
an
an
ak
aD
af
ab
ai
aX
ak
ak
an
ad
ad
an
aX
aa
aa
aa
"}
(12,1,1) = {"
aa
aa
ab
ab
aa
aa
aa
ac
ay
ak
aE
ab
ab
aj
ak
aL
aO
aa
aa
aa
aa
aa
aa
aa
aa
"}
(13,1,1) = {"
aa
aa
ab
aa
aa
at
at
au
az
ag
af
ab
ab
af
ag
af
aO
aa
aa
aa
aa
aa
aa
aa
aa
"}
(14,1,1) = {"
aa
ac
ah
af
af
af
am
am
am
ak
ai
af
af
ai
an
aX
aa
aa
ai
af
aa
aa
aa
aa
aa
"}
(15,1,1) = {"
aa
ac
af
an
an
an
an
an
ag
ak
aB
aI
aI
ai
ab
aa
aa
aX
am
af
aO
aa
aa
aa
aa
"}
(16,1,1) = {"
aa
ac
af
an
aq
aq
an
ao
aA
an
an
an
aX
aa
aa
aa
ab
an
aW
bh
aO
aa
aa
aa
aa
"}
(17,1,1) = {"
aa
aa
af
ad
af
af
an
av
ab
ao
an
ab
aa
af
aa
aa
aX
an
ag
aX
aX
aX
aa
aa
aa
"}
(18,1,1) = {"
aa
aa
af
ad
aa
aa
an
aw
ab
aC
an
aa
aa
aa
ab
aX
aR
aZ
be
ak
ab
ab
aa
aa
aa
"}
(19,1,1) = {"
aa
aa
ai
an
aa
aa
an
an
an
an
aX
aa
aa
ab
ao
an
ag
ad
ak
ak
ab
ab
ab
aa
aa
"}
(20,1,1) = {"
aa
aa
ah
ag
ab
ab
ag
am
am
am
aG
ab
aa
af
ao
an
aR
aO
aa
ak
aa
aa
aa
aa
aa
"}
(21,1,1) = {"
aa
aa
aj
an
aa
ab
aX
ax
as
am
af
ab
ab
af
ax
an
aW
aO
aa
bi
aa
aa
ab
aa
aa
"}
(22,1,1) = {"
aa
aa
af
ad
ar
aa
an
an
an
an
ag
an
ax
ap
aK
aX
ab
aa
aa
bi
ab
aa
ab
aa
aa
"}
(23,1,1) = {"
aa
aa
ab
ad
aa
ab
ab
an
aB
am
af
an
an
an
an
aX
ab
aa
aa
aX
aa
ab
aX
ab
aa
"}
(24,1,1) = {"
aa
ab
ab
an
ab
ab
an
an
an
an
ai
aG
af
af
af
aR
aZ
aa
aa
aX
ab
af
aX
aX
ab
"}
(25,1,1) = {"
aa
ab
af
aX
aX
aX
an
ab
ab
an
ab
ab
ab
an
an
aN
aX
aa
aa
aa
ab
ab
af
ab
aa
"}
