//MAP CONVERTED BY dmm2tgm.py THIS HEADER COMMENT PREVENTS RECONVERSION, DO NOT REMOVE
"aa" = (
/obj/structure/lattice,
/obj/structure/lattice,
/turf/template_noop,
/area/template_noop)
"ab" = (
/obj/structure/lattice,
/turf/template_noop,
/area/template_noop)
"ac" = (
/turf/template_noop,
/area/template_noop)
"ad" = (
/turf/wall/reinforced,
/area/template_noop)
"ae" = (
/turf/wall/low/with_glass/smart,
/area/template_noop)
"af" = (
/turf/floor/plating/airless,
/area/template_noop)
"ag" = (
/obj/structure/girder,
/turf/floor/plating/under/airless,
/area/template_noop)
"ah" = (
/turf/floor/plating/under/airless,
/area/template_noop)
"ai" = (
/obj/machinery/door/airlock/maintenance_common{
	name = "Service Maintenance";
	req_access = list(12)
	},
/turf/floor/tiled/techmaint_cargo/airless,
/area/template_noop)
"aj" = (
/turf/floor/tiled/techmaint/airless,
/area/template_noop)
"ak" = (
/obj/machinery/light/small,
/obj/spawner/traps/low_chance,
/turf/floor/tiled/techmaint/airless,
/area/template_noop)
"al" = (
/obj/machinery/light/small,
/turf/floor/tiled/techmaint/airless,
/area/template_noop)
"am" = (
/obj/spawner/scrap/sparse,
/turf/floor/tiled/techmaint/airless,
/area/template_noop)
"an" = (
/obj/structure/closet/emcloset,
/turf/floor/tiled/techmaint_perforated/airless,
/area/template_noop)
"ao" = (
/obj/spawner/pack/machine,
/turf/floor/plating/under/airless,
/area/template_noop)
"ap" = (
/obj/machinery/door/airlock/maintenance_interior{
	name = "Reserve Storage";
	req_access = list(12)
	},
/turf/floor/tiled/techmaint_cargo/airless,
/area/template_noop)
"ar" = (
/obj/spawner/junk/low_chance,
/turf/floor/tiled/techmaint/airless,
/area/template_noop)
"as" = (
/obj/machinery/light{
	dir = 4
	},
/turf/floor/plating/under/airless,
/area/template_noop)
"au" = (
/obj/machinery/light/small{
	dir = 8
	},
/turf/floor/tiled/techmaint/airless,
/area/template_noop)
"av" = (
/obj/machinery/light/small{
	dir = 4
	},
/turf/floor/tiled/techmaint/airless,
/area/template_noop)
"aw" = (
/turf/floor/tiled/steel/cargo/airless,
/area/template_noop)
"ax" = (
/obj/spawner/scrap/sparse/low_chance,
/turf/floor/tiled/techmaint/airless,
/area/template_noop)
"ay" = (
/obj/structure/table/rack,
/obj/spawner/ammo/lowcost/low_chance,
/obj/spawner/ammo/lowcost/low_chance,
/obj/spawner/ammo,
/turf/floor/tiled/techmaint/airless,
/area/template_noop)
"az" = (
/turf/wall,
/area/template_noop)
"aA" = (
/obj/structure/table/rack,
/obj/spawner/pack/tech_loot,
/obj/spawner/pack/tech_loot,
/obj/spawner/pack/tech_loot,
/obj/spawner/pack/tech_loot,
/turf/floor/tiled/techmaint/airless,
/area/template_noop)
"aB" = (
/obj/spawner/traps/low_chance,
/turf/floor/tiled/techmaint/airless,
/area/template_noop)
"aC" = (
/obj/structure/table/rack,
/obj/spawner/lowkeyrandom,
/obj/spawner/lowkeyrandom,
/obj/spawner/lowkeyrandom/low_chance,
/turf/floor/tiled/techmaint/airless,
/area/template_noop)
"aD" = (
/obj/structure/table/rack,
/obj/spawner/boxes,
/obj/spawner/boxes,
/obj/spawner/boxes/low_chance,
/turf/floor/tiled/techmaint/airless,
/area/template_noop)
"aE" = (
/obj/spawner/lowkeyrandom,
/obj/spawner/lowkeyrandom,
/obj/spawner/boxes/low_chance,
/obj/spawner/boxes/low_chance,
/obj/spawner/boxes/low_chance,
/turf/floor/tiled/steel/gray_perforated/airless,
/area/template_noop)
"aF" = (
/obj/structure/catwalk,
/turf/template_noop,
/area/template_noop)
"aG" = (
/obj/spawner/pack/tech_loot,
/obj/spawner/junkfood/rotten/low_chance,
/turf/floor/tiled/techmaint/airless,
/area/template_noop)
"aH" = (
/obj/spawner/closet/tech/low_chance,
/turf/floor/plating/under/airless,
/area/template_noop)
"aK" = (
/obj/machinery/light/small{
	dir = 1
	},
/turf/floor/tiled/techmaint/airless,
/area/template_noop)
"aL" = (
/obj/machinery/door/airlock/maintenance_common{
	name = "Service Maintenance";
	req_access = list(12)
	},
/turf/floor/tiled/steel/techfloor_grid/airless,
/area/template_noop)
"aM" = (
/obj/spawner/traps/low_chance,
/turf/floor/plating/under/airless,
/area/template_noop)
"aN" = (
/obj/structure/railing{
	dir = 1;
	tag = "icon-railing0 (NORTH)"
	},
/obj/spawner/junk/low_chance,
/turf/floor/plating/under/airless,
/area/template_noop)
"aQ" = (
/obj/structure/railing{
	dir = 1;
	tag = "icon-railing0 (NORTH)"
	},
/obj/structure/railing{
	dir = 4;
	tag = "icon-railing0 (EAST)"
	},
/turf/floor/plating/under/airless,
/area/template_noop)
"aS" = (
/obj/spawner/traps/wire_splicing/low_chance,
/obj/spawner/junk/low_chance,
/turf/floor/plating/under/airless,
/area/template_noop)
"aT" = (
/obj/spawner/junk/low_chance,
/obj/spawner/junk/low_chance,
/turf/floor/plating/under/airless,
/area/template_noop)
"aW" = (
/obj/spawner/traps/wire_splicing/low_chance,
/turf/floor/plating/under/airless,
/area/template_noop)
"aX" = (
/obj/structure/railing{
	dir = 4;
	tag = "icon-railing0 (EAST)"
	},
/turf/floor/plating/under/airless,
/area/template_noop)
"aY" = (
/obj/structure/sign/securearea{
	name = "EXPLOSION HAZARD";
	pixel_y = 32
	},
/turf/floor/tiled/techmaint_panels/airless,
/area/template_noop)
"aZ" = (
/obj/spawner/scrap/dense,
/turf/floor/tiled/techmaint_panels/airless,
/area/template_noop)
"ba" = (
/obj/spawner/scrap/dense/low_chance,
/turf/floor/tiled/techmaint_panels/airless,
/area/template_noop)
"bb" = (
/obj/structure/reagent_dispensers/fueltank/huge,
/obj/structure/sign/securearea{
	name = "EXPLOSION HAZARD";
	pixel_y = 32
	},
/turf/floor/tiled/techmaint_panels/airless,
/area/template_noop)
"bc" = (
/obj/spawner/junk/low_chance,
/turf/template_noop,
/area/template_noop)
"bd" = (
/obj/spawner/junkfood/rotten/low_chance,
/turf/floor/tiled/techmaint_panels/airless,
/area/template_noop)
"be" = (
/obj/structure/catwalk,
/turf/floor/plating/under/airless,
/area/template_noop)
"bf" = (
/obj/structure/railing{
	dir = 8;
	tag = "icon-railing0 (WEST)"
	},
/turf/floor/plating/under/airless,
/area/template_noop)
"bg" = (
/obj/structure/table/rack,
/obj/spawner/pack/tech_loot,
/obj/spawner/pack/tech_loot,
/obj/spawner/pack/tech_loot,
/obj/spawner/pack/tech_loot,
/obj/spawner/pack/tech_loot/low_chance,
/obj/spawner/pack/tech_loot/low_chance,
/obj/spawner/pack/tech_loot/low_chance,
/turf/floor/tiled/steel/gray_platform/airless,
/area/template_noop)
"bh" = (
/obj/spawner/scrap/sparse,
/turf/floor/tiled/steel/airless,
/area/template_noop)
"bi" = (
/mob/living/simple_animal/hostile/carp,
/turf/floor/plating/under/airless,
/area/template_noop)
"bj" = (
/obj/machinery/door/firedoor,
/obj/machinery/door/airlock{
	name = "Unisex Restrooms"
	},
/turf/floor/tiled/steel/cargo/airless,
/area/template_noop)
"bl" = (
/obj/spawner/junk/low_chance,
/turf/floor/plating/under/airless,
/area/template_noop)
"bm" = (
/obj/structure/catwalk,
/obj/spawner/traps/low_chance,
/turf/floor/plating/under/airless,
/area/template_noop)
"bn" = (
/obj/structure/table/rack,
/obj/spawner/material/building,
/obj/spawner/material/building,
/obj/spawner/material/building/low_chance,
/obj/spawner/material/building/low_chance,
/obj/machinery/light/small{
	dir = 8
	},
/turf/floor/plating/under/airless,
/area/template_noop)
"bo" = (
/turf/floor/tiled/steel/airless,
/area/template_noop)
"bq" = (
/obj/machinery/light/small{
	dir = 8
	},
/turf/floor/plating/under/airless,
/area/template_noop)
"bs" = (
/obj/structure/catwalk,
/obj/machinery/light/small{
	dir = 8
	},
/turf/floor/plating/under/airless,
/area/template_noop)
"bt" = (
/obj/structure/railing{
	dir = 8;
	tag = "icon-railing0 (WEST)"
	},
/obj/spawner/traps/wire_splicing/low_chance,
/turf/floor/plating/under/airless,
/area/template_noop)
"bu" = (
/obj/structure/closet/oldstyle,
/obj/spawner/pack/tech_loot,
/obj/spawner/pack/tech_loot,
/obj/spawner/pack/tech_loot,
/obj/spawner/pack/tech_loot/low_chance,
/obj/spawner/pack/tech_loot/low_chance,
/obj/spawner/pack/tech_loot/low_chance,
/obj/spawner/pack/tech_loot/low_chance,
/turf/floor/plating/under/airless,
/area/template_noop)
"bv" = (
/obj/structure/toilet{
	dir = 4
	},
/obj/machinery/light{
	dir = 1
	},
/obj/spawner/junk/low_chance,
/turf/floor/tiled/steel/airless,
/area/template_noop)
"bC" = (
/obj/structure/railing{
	dir = 8;
	tag = "icon-railing0 (WEST)"
	},
/obj/spawner/junkfood/rotten/low_chance,
/turf/floor/plating/under/airless,
/area/template_noop)
"bD" = (
/obj/spawner/lowkeyrandom,
/obj/spawner/lowkeyrandom,
/obj/spawner/lowkeyrandom,
/turf/floor/plating/under/airless,
/area/template_noop)
"bE" = (
/mob/living/simple_animal/hostile/carp,
/turf/floor/tiled/techmaint/airless,
/area/template_noop)
"bG" = (
/obj/effect/decal/cleanable/blood/oil,
/turf/floor/plating/under/airless,
/area/template_noop)
"bI" = (
/obj/machinery/camera/network/second_section{
	dir = 1
	},
/obj/spawner/junk/low_chance,
/turf/floor/plating/under/airless,
/area/template_noop)
"bJ" = (
/obj/structure/railing{
	dir = 1;
	tag = "icon-railing0 (NORTH)"
	},
/turf/floor/plating/under/airless,
/area/template_noop)
"bL" = (
/mob/living/simple_animal/hostile/bear,
/turf/floor/tiled/techmaint/airless,
/area/template_noop)
"bN" = (
/obj/machinery/light{
	dir = 1
	},
/obj/spawner/scrap/dense,
/mob/living/simple_animal/hostile/bear,
/turf/floor/tiled/steel/airless,
/area/template_noop)
"mW" = (
/obj/spawner/scrap/dense,
/turf/floor/tiled/steel/cargo/airless,
/area/template_noop)

(1,1,1) = {"
ag
ah
ag
ac
ac
ac
ac
ac
ac
ac
ac
ac
ac
ac
ac
ab
ab
aF
aF
aF
aF
ab
ac
ac
ac
"}
(2,1,1) = {"
ag
mW
ab
ac
ac
ac
ac
ac
ac
ac
ac
ac
ac
ac
ac
ab
ag
ag
ab
ag
ad
ad
ad
ad
ab
"}
(3,1,1) = {"
ah
aj
ag
ac
ac
ac
ac
ac
ac
ac
ac
ac
ac
ac
ac
aF
ad
aY
ah
bl
bq
ar
bG
ag
ac
"}
(4,1,1) = {"
ab
ah
ab
ac
ac
ac
ac
ac
ac
ac
ac
ac
ac
ac
ac
aF
ad
aZ
ah
ab
bE
aj
ah
ab
ac
"}
(5,1,1) = {"
ac
ac
ac
ac
ac
ac
ac
ac
ac
ac
ac
ab
ab
ac
aF
aF
ad
ba
ah
ab
aj
aj
bl
ad
ag
"}
(6,1,1) = {"
ac
ac
ac
ac
ac
ab
ab
ab
ac
ac
ab
ab
ad
ab
ac
ac
ad
bb
bd
az
aj
ah
ah
ad
ac
"}
(7,1,1) = {"
ac
ac
ac
ac
ab
ab
ac
ab
ab
ab
ah
ah
ad
ad
ad
ad
ad
ad
ag
ac
ao
ah
bI
ad
ac
"}
(8,1,1) = {"
ac
ac
ac
ac
ab
ab
ac
ac
ab
ah
ah
ah
az
am
aj
bL
ad
ac
ac
ac
ag
ap
ad
ad
ab
"}
(9,1,1) = {"
ac
ac
ac
ab
ab
ab
ac
ac
ad
ah
ah
aw
ad
az
aG
aB
ad
ac
ac
ac
ae
bm
ae
ab
ac
"}
(10,1,1) = {"
ag
ag
ag
ad
ad
ad
ab
ab
ad
an
aj
aj
aA
az
az
aL
ad
bc
ac
ac
ad
be
ad
ag
ag
"}
(11,1,1) = {"
ab
ah
ah
ah
bi
ad
ac
ac
ad
ao
aj
bE
aA
az
aH
aM
ag
ag
ab
ad
ad
be
ah
ab
ac
"}
(12,1,1) = {"
ab
ag
ag
ad
ai
ad
ac
ac
ag
ao
ah
aj
ax
az
ab
ab
ab
ab
be
bm
bs
be
bJ
ab
ac
"}
(13,1,1) = {"
ac
ab
ab
ad
am
ad
ab
ab
ab
ao
as
aj
am
ag
ab
ac
ac
ab
bf
bf
bt
bC
ah
ab
ac
"}
(14,1,1) = {"
ac
aa
ac
ae
ah
ae
ac
ac
ag
ag
ad
ai
ag
ag
ab
ac
ac
ag
ag
ad
ad
ad
ag
ab
ac
"}
(15,1,1) = {"
ac
ab
ab
ae
ah
ab
ac
ac
ac
ac
ad
aj
aB
ai
ab
ab
ab
ag
az
bh
bo
aE
bD
ac
ac
"}
(16,1,1) = {"
ac
ac
ab
af
ah
ae
ac
ac
ag
ad
ad
ar
az
ag
ah
aN
bl
ad
ad
ad
ah
ah
ab
ac
ac
"}
(17,1,1) = {"
ac
ac
ab
ad
ak
ad
ab
ab
ag
ab
ah
ah
aC
az
bE
aN
aS
ad
bg
bn
ab
ab
ab
ac
ac
"}
(18,1,1) = {"
ac
ac
ac
ae
aj
ae
ac
ab
ad
ap
az
az
az
az
ar
aN
aT
ad
bg
ah
ah
ab
ac
ac
ac
"}
(19,1,1) = {"
ac
ac
ac
ae
bE
ae
ac
ad
ad
aj
au
ax
ax
az
aj
aN
bl
ad
bg
bo
ah
ab
ac
ac
ac
"}
(20,1,1) = {"
ac
ac
ac
ae
aj
ae
ac
ad
am
aj
ar
ay
aD
az
be
bJ
bl
ad
bh
bh
bu
bu
ab
ab
ac
"}
(21,1,1) = {"
ac
ac
ab
ad
al
ad
ab
ad
aj
bE
aj
ah
ah
az
aK
bJ
ah
ad
ad
ad
ad
ag
ag
ab
ac
"}
(22,1,1) = {"
ac
ac
ac
ae
ah
ae
ac
ad
am
aj
aj
ah
ab
ag
aj
bJ
aW
az
bN
az
bv
ag
ah
ab
ac
"}
(23,1,1) = {"
ag
ac
ac
ab
ah
ae
ac
ad
ad
ar
av
ah
ab
ag
aj
bJ
bl
az
bj
az
bj
az
bj
ac
ac
"}
(24,1,1) = {"
ah
ah
ab
ab
ab
ag
ac
ac
ad
ap
az
az
ab
ab
aa
aQ
aX
az
ah
ah
ah
ah
ab
ac
ac
"}
(25,1,1) = {"
ag
ad
ae
ac
ab
ab
ab
ab
ab
ab
ac
ac
ac
ac
ab
ab
ab
ag
ab
ab
ab
ab
ab
ac
ac
"}
