"aa" = (/turf/template_noop,/area/template_noop)
"ab" = (/obj/structure/lattice,/turf/template_noop,/area/template_noop)
"ac" = (/obj/machinery/atmospherics/pipe/simple/visible/green,/turf/simulated/floor/plating/under,/area/template_noop)
"ad" = (/obj/spawner/pack/machine,/turf/simulated/floor/tiled/dark/danger,/area/template_noop)
"ae" = (/obj/structure/girder,/turf/simulated/floor/plating/under,/area/template_noop)
"af" = (/obj/spawner/lowkeyrandom/low_chance,/obj/spawner/lowkeyrandom/low_chance,/turf/simulated/floor/tiled/techmaint,/area/template_noop)
"ag" = (/obj/spawner/pack/machine,/turf/simulated/floor/tiled/techmaint,/area/template_noop)
"ah" = (/obj/spawner/junkfood/rotten,/turf/simulated/floor/tiled/dark/danger,/area/template_noop)
"ai" = (/obj/machinery/atmospherics/unary/vent_pump/high_volume{dir = 4; frequency = 1379; id_tag = "atmos_airlock_pump"; name = "Atmospherics Airlock Pump"},/turf/simulated/floor/plating/under,/area/template_noop)
"aj" = (/obj/machinery/camera/network/engineering{dir = 4},/turf/simulated/floor/plating/under,/area/template_noop)
"ak" = (/obj/machinery/atmospherics/pipe/simple/visible/yellow,/turf/simulated/floor/plating/under,/area/template_noop)
"al" = (/obj/machinery/atmospherics/pipe/manifold/visible/yellow{dir = 8},/turf/simulated/floor/plating/under,/area/template_noop)
"am" = (/obj/machinery/atmospherics/pipe/simple/visible/yellow{dir = 9},/turf/simulated/floor/plating/under,/area/template_noop)
"an" = (/obj/spawner/scrap/sparse/low_chance,/turf/simulated/floor/plating/under,/area/template_noop)
"ao" = (/turf/simulated/floor/plating/under,/area/template_noop)
"ap" = (/obj/machinery/camera/network/engineering{dir = 1},/turf/simulated/floor/plating/under,/area/template_noop)
"aq" = (/obj/spawner/junk,/turf/simulated/floor/plating/under,/area/template_noop)
"ar" = (/obj/spawner/scrap/dense,/turf/simulated/floor/plating/under,/area/template_noop)
"as" = (/obj/spawner/junkfood/rotten,/turf/simulated/floor/plating/under,/area/template_noop)
"at" = (/obj/spawner/scrap/dense,/turf/simulated/floor/tiled/techmaint,/area/template_noop)
"au" = (/obj/machinery/atmospherics/portables_connector{dir = 8},/turf/simulated/floor/plating/under,/area/template_noop)
"av" = (/obj/machinery/atmospherics/pipe/simple/visible/yellow{dir = 5; tag = "icon-intact (NORTHEAST)"},/turf/simulated/floor/plating/under,/area/template_noop)
"aw" = (/obj/machinery/atmospherics/pipe/simple/visible/yellow{dir = 4},/turf/simulated/floor/plating/under,/area/template_noop)
"ax" = (/obj/machinery/atmospherics/pipe/simple/visible/green,/obj/machinery/atmospherics/pipe/simple/visible/yellow{dir = 4},/turf/simulated/floor/plating/under,/area/template_noop)
"ay" = (/obj/machinery/atmospherics/valve/digital/open{dir = 4; name = "Nitrogen Outlet Valve"},/turf/simulated/floor/plating/under,/area/template_noop)
"az" = (/obj/machinery/camera/network/engineering{dir = 1},/obj/spawner/junk,/turf/simulated/floor/tiled/dark/danger,/area/template_noop)
"aA" = (/turf/simulated/wall/r_wall,/area/template_noop)
"aB" = (/obj/machinery/door/firedoor,/obj/effect/window_lwall_spawn/smartspawn,/turf/simulated/floor/plating,/area/template_noop)
"aC" = (/obj/spawner/junk,/turf/simulated/floor/tiled/dark/danger,/area/template_noop)
"aD" = (/obj/machinery/atmospherics/pipe/simple/visible/green,/turf/simulated/floor/tiled/dark/danger,/area/template_noop)
"aE" = (/mob/living/simple_animal/hostile/carp,/turf/simulated/floor/tiled/dark/danger,/area/template_noop)
"aF" = (/obj/machinery/atmospherics/pipe/manifold/visible/yellow{dir = 8},/turf/simulated/floor/tiled/dark/danger,/area/template_noop)
"aG" = (/obj/machinery/atmospherics/binary/passive_gate{dir = 4; name = "O2 to Propulsion"},/turf/simulated/floor/tiled/dark/danger,/area/template_noop)
"aH" = (/obj/machinery/atmospherics/pipe/simple/visible/yellow{dir = 10},/turf/simulated/floor/tiled/dark/danger,/area/template_noop)
"aI" = (/obj/machinery/light/small{dir = 1},/turf/simulated/floor/plating/under,/area/template_noop)
"aJ" = (/obj/spawner/scrap/sparse,/turf/simulated/floor/plating/under,/area/template_noop)
"aK" = (/obj/machinery/atmospherics/pipe/simple/visible/green{dir = 5; tag = "icon-intact (NORTHEAST)"},/turf/simulated/floor/tiled/dark/danger,/area/template_noop)
"aL" = (/obj/machinery/atmospherics/pipe/simple/visible/green{dir = 4; tag = "icon-intact (EAST)"},/turf/simulated/floor/tiled/dark/danger,/area/template_noop)
"aM" = (/obj/machinery/atmospherics/pipe/simple/visible/green{dir = 10; tag = "icon-intact (SOUTHWEST)"},/obj/machinery/meter,/turf/simulated/floor/tiled/dark/danger,/area/template_noop)
"aN" = (/obj/machinery/atmospherics/pipe/simple/visible/yellow{dir = 5; tag = "icon-intact (NORTHEAST)"},/obj/structure/lattice,/turf/template_noop,/area/template_noop)
"aO" = (/obj/machinery/atmospherics/pipe/simple/visible/yellow,/obj/machinery/meter,/turf/simulated/floor/tiled/dark/danger,/area/template_noop)
"aP" = (/mob/living/simple_animal/hostile/bear,/turf/simulated/floor/tiled/techmaint,/area/template_noop)
"aQ" = (/obj/structure/lattice,/obj/spawner/junk,/turf/template_noop,/area/template_noop)
"aR" = (/mob/living/simple_animal/hostile/carp,/turf/template_noop,/area/template_noop)
"aS" = (/obj/machinery/atmospherics/pipe/simple/visible/green,/obj/machinery/meter,/turf/simulated/floor/tiled/dark/danger,/area/template_noop)
"aT" = (/obj/effect/window_lwall_spawn/smartspawn,/turf/simulated/floor/plating,/area/template_noop)
"aU" = (/obj/machinery/atmospherics/pipe/simple/visible/yellow,/obj/effect/window_lwall_spawn/smartspawn,/turf/simulated/floor/plating,/area/template_noop)
"aV" = (/obj/machinery/atmospherics/pipe/simple/visible/yellow{dir = 6},/obj/effect/window_lwall_spawn/smartspawn,/turf/simulated/floor/plating,/area/template_noop)
"aW" = (/obj/machinery/atmospherics/pipe/simple/visible/yellow{dir = 4},/obj/effect/window_lwall_spawn/smartspawn,/turf/simulated/floor/plating,/area/template_noop)
"aX" = (/obj/machinery/atmospherics/pipe/simple/visible/green,/obj/machinery/atmospherics/pipe/simple/visible/yellow{dir = 4},/turf/simulated/floor/tiled/dark/danger,/area/template_noop)
"aY" = (/obj/machinery/atmospherics/binary/passive_gate{dir = 8; name = "N2 to Core"},/turf/simulated/floor/tiled/dark/danger,/area/template_noop)
"aZ" = (/obj/machinery/atmospherics/pipe/manifold/visible/yellow{dir = 4; tag = "icon-map (EAST)"},/turf/simulated/floor/tiled/dark/danger,/area/template_noop)
"ba" = (/turf/simulated/wall,/area/template_noop)
"bb" = (/obj/machinery/light/small,/turf/simulated/floor/plating/under,/area/template_noop)
"bc" = (/obj/machinery/door/firedoor,/obj/machinery/atmospherics/pipe/simple/visible/green,/obj/effect/window_lwall_spawn/smartspawn,/turf/simulated/floor/plating,/area/template_noop)
"bd" = (/obj/machinery/door/firedoor,/obj/machinery/atmospherics/pipe/simple/visible/yellow,/obj/effect/window_lwall_spawn/smartspawn,/turf/simulated/floor/plating,/area/template_noop)
"be" = (/obj/machinery/atmospherics/pipe/simple/visible/yellow,/obj/machinery/meter,/turf/simulated/floor/plating/under,/area/template_noop)
"bf" = (/mob/living/simple_animal/hostile/carp,/turf/simulated/floor/tiled/techmaint,/area/template_noop)
"bg" = (/obj/structure/extinguisher_cabinet{pixel_y = 27},/turf/simulated/floor/plating/under,/area/template_noop)
"bh" = (/obj/structure/railing{dir = 1; tag = "icon-railing0 (NORTH)"},/obj/spawner/junkfood/rotten,/turf/simulated/floor/plating/under,/area/template_noop)
"bi" = (/obj/spawner/traps,/turf/simulated/floor/tiled/techmaint,/area/template_noop)
"bj" = (/obj/machinery/atmospherics/pipe/simple/hidden/supply{dir = 4},/turf/simulated/floor/plating/under,/area/template_noop)
"bk" = (/obj/structure/railing,/turf/simulated/floor/plating/under,/area/template_noop)
"bl" = (/obj/structure/sign/atmos_co2{pixel_y = 32},/turf/simulated/floor/plating/under,/area/template_noop)
"bm" = (/obj/structure/lattice,/obj/machinery/atmospherics/pipe/simple/visible/green,/turf/template_noop,/area/template_noop)
"bn" = (/obj/structure/lattice,/obj/machinery/atmospherics/pipe/simple/visible/yellow,/turf/template_noop,/area/template_noop)
"bo" = (/obj/spawner/junk/low_chance,/turf/simulated/floor/plating/under,/area/template_noop)
"bp" = (/obj/structure/table/reinforced,/obj/item/stack/material/glass{amount = 120},/obj/spawner/junk,/turf/simulated/floor/tiled/dark/techfloor_grid,/area/template_noop)
"bq" = (/obj/structure/table/reinforced,/obj/item/stack/material/steel{amount = 120},/obj/spawner/junk,/turf/simulated/floor/tiled/dark/techfloor_grid,/area/template_noop)
"br" = (/obj/structure/table/reinforced,/obj/item/weapon/tank/emergency_oxygen{pixel_x = -8},/obj/item/weapon/tank/emergency_oxygen{pixel_x = -8},/obj/item/clothing/mask/breath{pixel_x = 4},/obj/item/clothing/mask/breath{pixel_x = 4},/obj/spawner/junk,/turf/simulated/floor/tiled/dark/techfloor_grid,/area/template_noop)
"bs" = (/obj/machinery/door/firedoor,/obj/machinery/door/airlock/engineering{name = "Wasting Room"},/turf/simulated/floor/tiled/dark/techfloor_grid,/area/template_noop)
"bt" = (/turf/simulated/floor/tiled/techmaint,/area/template_noop)
"bu" = (/obj/machinery/atmospherics/pipe/simple/visible/green,/obj/machinery/door/firedoor,/obj/effect/window_lwall_spawn/plasma,/turf/simulated/floor/plating,/area/template_noop)
"bv" = (/obj/machinery/door/firedoor,/obj/effect/window_lwall_spawn/plasma,/turf/simulated/floor/plating,/area/template_noop)
"bw" = (/obj/machinery/atmospherics/pipe/simple/visible/yellow,/obj/machinery/door/firedoor,/obj/effect/window_lwall_spawn/plasma,/turf/simulated/floor/plating,/area/template_noop)
"bx" = (/obj/machinery/atmospherics/pipe/simple/visible/yellow{dir = 10},/turf/simulated/floor/plating/under,/area/template_noop)
"by" = (/obj/structure/table/reinforced,/obj/item/weapon/tank/emergency_oxygen/double,/obj/machinery/light/small,/turf/simulated/floor/plating/under,/area/template_noop)
"bz" = (/obj/structure/cable/green{d1 = 1; d2 = 2; icon_state = "1-2"},/obj/machinery/atmospherics/pipe/simple/hidden/scrubbers,/obj/machinery/atmospherics/pipe/simple/hidden/supply,/turf/simulated/floor/plating/under,/area/template_noop)
"bA" = (/obj/structure/railing{dir = 8; tag = "icon-railing0 (WEST)"},/turf/simulated/floor/plating/under,/area/template_noop)
"bB" = (/obj/structure/catwalk,/obj/structure/cable/green{d2 = 2; icon_state = "0-2"},/turf/simulated/floor/plating/under,/area/template_noop)
"bC" = (/obj/effect/window_lwall_spawn/smartspawn,/turf/simulated/floor/plating/under,/area/template_noop)
"bD" = (/obj/structure/railing{dir = 1; tag = "icon-railing0 (NORTH)"},/obj/structure/cable/green{d1 = 4; d2 = 8; icon_state = "4-8"},/turf/simulated/floor/plating/under,/area/template_noop)
"bK" = (/obj/structure/catwalk,/obj/structure/sign/atmos_co2{pixel_y = 32},/turf/simulated/floor/plating/under,/area/template_noop)
"bL" = (/obj/structure/catwalk,/turf/simulated/floor/plating/under,/area/template_noop)
"bM" = (/obj/machinery/atmospherics/pipe/simple/visible/yellow,/obj/structure/catwalk,/turf/simulated/floor/plating/under,/area/template_noop)
"bS" = (/obj/spawner/junk/low_chance,/turf/simulated/floor/plating,/area/template_noop)
"bW" = (/obj/machinery/door/airlock/maintenance_engineering{name = "Engineering Maintenance"; req_access = list(10)},/turf/simulated/floor/tiled/techmaint_cargo,/area/template_noop)
"bX" = (/obj/machinery/atmospherics/pipe/simple/visible/yellow,/obj/structure/catwalk,/obj/structure/sign/atmos_o2{pixel_x = -32},/turf/simulated/floor/plating/under,/area/template_noop)
"ca" = (/obj/spawner/junk/low_chance,/turf/simulated/floor/tiled/techmaint,/area/template_noop)
"cb" = (/turf/simulated/floor/tiled/dark/techfloor,/area/template_noop)
"cc" = (/obj/machinery/firealarm{pixel_y = 28},/turf/simulated/floor/tiled/dark/techfloor,/area/template_noop)
"ci" = (/obj/machinery/door/firedoor,/obj/machinery/door/airlock/maintenance_engineering{name = "Atmospherics Maintenance"; req_access = list(24)},/turf/simulated/floor/tiled/techmaint_cargo,/area/template_noop)
"cj" = (/obj/machinery/atmospherics/unary/vent_pump/on{dir = 4},/turf/simulated/floor/tiled/dark/techfloor,/area/template_noop)
"ck" = (/obj/machinery/atmospherics/pipe/simple/hidden/supply{dir = 4},/turf/simulated/floor/tiled/dark/techfloor,/area/template_noop)
"cn" = (/obj/spawner/pack/machine,/turf/simulated/floor/tiled/techmaint_panels,/area/template_noop)
"cp" = (/obj/structure/table/rack,/obj/spawner/lowkeyrandom,/turf/simulated/floor/tiled/techmaint,/area/template_noop)
"cv" = (/obj/machinery/light/small{dir = 1},/turf/simulated/floor/tiled/techmaint,/area/template_noop)
"cx" = (/obj/machinery/camera/network/engineering,/turf/simulated/floor/tiled/techmaint,/area/template_noop)
"cz" = (/obj/structure/table/reinforced,/obj/spawner/pack/tech_loot,/obj/spawner/pack/tech_loot,/obj/spawner/pack/tech_loot,/obj/spawner/pack/tech_loot,/turf/simulated/floor/tiled/techmaint,/area/template_noop)
"cA" = (/obj/effect/decal/cleanable/dirt,/obj/structure/table/reinforced,/obj/spawner/tank,/turf/simulated/floor/tiled/techmaint,/area/template_noop)
"cB" = (/obj/machinery/door/firedoor,/obj/machinery/door/airlock/maintenance_engineering{name = "Atmospherics Maintenance"; req_access = list(24)},/obj/machinery/atmospherics/pipe/simple/hidden/scrubbers,/obj/machinery/atmospherics/pipe/simple/hidden/supply,/obj/structure/cable/green{d1 = 1; d2 = 2; icon_state = "1-2"},/turf/simulated/floor/tiled/techmaint_cargo,/area/template_noop)
"cE" = (/obj/structure/railing{dir = 1; tag = "icon-railing0 (NORTH)"},/obj/structure/cable/green{d1 = 4; d2 = 8; icon_state = "4-8"},/obj/machinery/atmospherics/pipe/simple/hidden/scrubbers{dir = 4},/obj/spawner/powercell/low_chance,/turf/simulated/floor/plating/under,/area/template_noop)
"cF" = (/obj/structure/railing{dir = 4; tag = "icon-railing0 (EAST)"},/obj/structure/railing{dir = 1; tag = "icon-railing0 (NORTH)"},/obj/structure/cable/green{d1 = 4; d2 = 8; icon_state = "4-8"},/obj/machinery/atmospherics/pipe/simple/hidden/scrubbers{dir = 4},/obj/machinery/atmospherics/pipe/simple/hidden/supply{dir = 6},/obj/spawner/traps/wire_splicing/low_chance,/turf/simulated/floor/plating/under,/area/template_noop)
"cG" = (/obj/structure/catwalk,/obj/structure/cable/green{d1 = 1; d2 = 4; icon_state = "1-4"},/obj/structure/cable/green{d1 = 4; d2 = 8; icon_state = "4-8"},/obj/machinery/atmospherics/pipe/simple/hidden/scrubbers{dir = 4},/obj/machinery/atmospherics/pipe/simple/hidden/supply{dir = 4},/turf/simulated/floor/plating/under,/area/template_noop)
"cH" = (/obj/structure/catwalk,/obj/structure/cable/green{d1 = 4; d2 = 8; icon_state = "4-8"},/obj/machinery/atmospherics/pipe/simple/hidden/scrubbers{dir = 4},/obj/machinery/atmospherics/pipe/simple/hidden/supply{dir = 4},/turf/simulated/floor/plating/under,/area/template_noop)
"cI" = (/obj/structure/railing,/obj/structure/railing{dir = 8; tag = "icon-railing0 (WEST)"},/obj/structure/railing{dir = 4; tag = "icon-railing0 (EAST)"},/obj/structure/cable/green{d1 = 4; d2 = 8; icon_state = "4-8"},/obj/machinery/atmospherics/pipe/simple/hidden/scrubbers{dir = 4},/obj/machinery/atmospherics/pipe/simple/hidden/supply{dir = 4},/turf/simulated/floor/plating/under,/area/template_noop)
"cJ" = (/obj/structure/railing{dir = 8; tag = "icon-railing0 (WEST)"},/obj/structure/railing,/obj/structure/cable/green{d1 = 4; d2 = 8; icon_state = "4-8"},/obj/machinery/atmospherics/pipe/simple/hidden/scrubbers{dir = 4},/obj/machinery/atmospherics/pipe/simple/hidden/supply{dir = 4},/turf/simulated/floor/plating/under,/area/template_noop)
"cK" = (/obj/structure/railing,/obj/structure/cable/green{d1 = 4; d2 = 8; icon_state = "4-8"},/obj/machinery/atmospherics/pipe/simple/hidden/scrubbers{dir = 4},/obj/machinery/atmospherics/pipe/simple/hidden/supply{dir = 4},/turf/simulated/floor/plating/under,/area/template_noop)
"cL" = (/obj/structure/railing,/obj/structure/cable/green{d1 = 4; d2 = 8; icon_state = "4-8"},/obj/machinery/atmospherics/pipe/manifold/hidden/scrubbers{dir = 1},/obj/machinery/atmospherics/pipe/simple/hidden/supply{dir = 4},/turf/simulated/floor/plating/under,/area/template_noop)
"cM" = (/obj/structure/railing,/obj/structure/cable/green{d1 = 2; d2 = 8; icon_state = "2-8"},/obj/structure/cable/green{d1 = 2; d2 = 4; icon_state = "2-4"},/obj/machinery/atmospherics/pipe/manifold/hidden/supply{dir = 1},/obj/machinery/atmospherics/pipe/simple/hidden/scrubbers{dir = 4},/turf/simulated/floor/plating/under,/area/template_noop)
"cO" = (/obj/structure/cable/green{d1 = 4; d2 = 8; icon_state = "4-8"},/obj/machinery/atmospherics/pipe/simple/hidden/scrubbers{dir = 4},/obj/machinery/atmospherics/pipe/simple/hidden/supply{dir = 4},/turf/simulated/floor/plating/under,/area/template_noop)
"cP" = (/obj/structure/railing{dir = 4; tag = "icon-railing0 (EAST)"},/obj/structure/cable/green{d1 = 4; d2 = 8; icon_state = "4-8"},/obj/machinery/atmospherics/pipe/simple/hidden/scrubbers{dir = 4},/obj/machinery/atmospherics/pipe/simple/hidden/supply{dir = 4},/obj/spawner/traps/wire_splicing/low_chance,/turf/simulated/floor/plating/under,/area/template_noop)
"cQ" = (/obj/structure/catwalk,/obj/structure/cable/green{d1 = 1; d2 = 8; icon_state = "1-8"},/obj/machinery/atmospherics/pipe/simple/hidden/scrubbers{dir = 9},/obj/machinery/atmospherics/pipe/simple/hidden/supply{dir = 9},/turf/simulated/floor/plating/under,/area/template_noop)
"cT" = (/obj/structure/railing,/obj/machinery/atmospherics/pipe/simple/hidden/supply{dir = 4},/turf/simulated/floor/plating/under,/area/template_noop)
"cU" = (/obj/structure/railing,/obj/structure/railing{dir = 4; tag = "icon-railing0 (EAST)"},/obj/machinery/atmospherics/pipe/simple/hidden/supply{dir = 9},/turf/simulated/floor/plating/under,/area/template_noop)
"cV" = (/obj/structure/catwalk,/obj/machinery/light/small,/turf/simulated/floor/plating/under,/area/template_noop)
"cW" = (/obj/structure/catwalk,/obj/machinery/atmospherics/pipe/simple/hidden/scrubbers,/turf/simulated/floor/plating/under,/area/template_noop)
"cX" = (/obj/structure/catwalk,/obj/structure/cable/green{d1 = 1; d2 = 2; icon_state = "1-2"},/obj/machinery/atmospherics/pipe/simple/hidden/supply,/turf/simulated/floor/plating/under,/area/template_noop)
"cY" = (/obj/structure/railing,/obj/structure/railing{dir = 8; tag = "icon-railing0 (WEST)"},/turf/simulated/floor/plating/under,/area/template_noop)
"cZ" = (/obj/structure/railing,/obj/structure/railing{dir = 4; tag = "icon-railing0 (EAST)"},/turf/simulated/floor/plating/under,/area/template_noop)
"db" = (/obj/structure/sign/vacuum,/turf/simulated/wall/r_wall,/area/template_noop)
"dc" = (/obj/machinery/door/airlock/external{frequency = 1379; icon_state = "door_locked"; id_tag = "atmos_airlock_door_int"; locked = 1; name = "Internal Atmospherics Airlock"},/turf/simulated/floor/tiled/steel/cargo,/area/template_noop)
"dd" = (/obj/structure/railing{dir = 1; tag = "icon-railing0 (NORTH)"},/obj/machinery/atmospherics/pipe/simple/visible/universal,/turf/simulated/floor/plating/under,/area/template_noop)
"de" = (/obj/structure/cable/green{d1 = 1; d2 = 2; icon_state = "1-2"},/obj/structure/railing{dir = 1; tag = "icon-railing0 (NORTH)"},/obj/machinery/atmospherics/pipe/simple/visible/universal,/turf/simulated/floor/plating/under,/area/template_noop)
"df" = (/obj/effect/decal/cleanable/dirt,/obj/structure/table/rack,/obj/spawner/pack/tech_loot,/obj/spawner/pack/tech_loot,/turf/simulated/floor/tiled/techmaint,/area/template_noop)
"dh" = (/obj/machinery/atmospherics/pipe/simple/hidden{dir = 4},/turf/simulated/wall,/area/template_noop)
"di" = (/obj/machinery/atmospherics/pipe/tank/air{dir = 8},/turf/simulated/floor/plating,/area/template_noop)
"dj" = (/obj/machinery/atmospherics/pipe/simple/visible/red,/obj/effect/window_lwall_spawn/smartspawn,/turf/simulated/floor/plating,/area/template_noop)
"dk" = (/obj/structure/cable/green{d1 = 1; d2 = 2; icon_state = "1-2"},/obj/machinery/atmospherics/pipe/simple/visible/blue,/obj/effect/window_lwall_spawn/smartspawn,/turf/simulated/floor/plating,/area/template_noop)

(1,1,1) = {"
aaaaaaaaaaabababaaaaaaabaaabaaaaaaaaaaaaababaaaaaa
aaaaaaababaoaoaoaoaoaoakaoakabababaoakalamaoababaa
aaaaabaoaoapboaoaoacaoalauavawawawaxamavaybxaoaoab
aaaaabaeaBaAaAaBaAaDadaFaGaHahazaCaKaLaMadaOaoaoaa
aaaaaaaaaaabaaaaaAaSaEaOaTaUaTaAaTaVaWaXaYaZaAbaaa
aaaAaAaAaBaAababaAbcaBbdaAbeabaeababaAaBaBaBaAaIaa
abaAbkblanaAababaAbmabbnaAakaoaraoboaAaJababaaaaaa
abbsbtaAaoaAaAaAaAbubvbwaAaNawbxboboaAaoaaaaaaaaaa
abaAaPbAaoaoaqaraAaQababaeaeaAaUaTaAaAabaRaaaaaaaa
aaaAaAaAaAaAaAasaAabaaabaoaobLbMbAboaAabaaabaebbaa
aaabaAatafaAbSaoaeabaaaaaaaaaAbMaAaAaAabababaAaeaa
aaaaaAaAbWaAaAbkaAaAaeaaaaaaaAbXbtbfaAaAaAaAaAabaa
aaaaabaebfbtbLbLbLbKabaaaaabaAbMcabtaAcbcbccbgabaa
aaabaAaAaAaAbhaAaAaAaAaraeboaAbCaAbicicbcjckbjabaa
aaabaAcncnaAaAaAcncnaAaAaAaoaAaraAcpaAbpbqbrbybzae
aaaAaAbtbtcvbBcxcaaPczcAaAbWaAaeaAaAaAaAaAaAaAcBaA
aaaAarbDcEcFcGcHcHcHcHcHcIcHcJcKcKcLcMcKcKcOcPcQaA
aaaAaqbkcTcUbLbLbLbLbLbLbLbLcVbLbLcWcXbLbLcYcZbLaT
abaAaAbtbtcabtagbtcabtbtdbdcaAaTaAdddeaAbibtaPbtaT
aaaaaAaTaTaAaAaAaTaTaAdfaAaidhdiaAdjdkaAbWaAaAaAaA
aaaaaaaaaaaaaaaaaaabaAaAaAajaAaAaAababaAataAabaaaa
aaaaaaaaaaaaaaaaaaaaaaabaeaoaeabaaaaaaaAaAaAaaaaaa
aaaaaaaaaaaaaaaaaaaaaaabababababaaaaaaaaaaaaaaaaaa
aaaaaaaaaaaaaaaaaaaaaaaaaaaaaaaaaaaaaaaaaaaaaaaaaa
aaaaaaaaaaaaaaaaaaaaaaaaaaaaaaaaaaaaaaaaaaaaaaaaaa
"}
