"a" = (/turf/simulated/floor/tiled/techmaint,/area/deepmaint)
"b" = (/turf/simulated/floor/tiled/techmaint_cargo,/area/deepmaint)
"c" = (/turf/simulated/floor/tiled/techmaint_panels,/area/deepmaint)
"d" = (/turf/simulated/floor/tiled/techmaint_perforated,/area/deepmaint)

(1,1,1) = {"
aaaaaaaaaaa
aaaaaaaaaaa
aaaaaaaaaaa
bbbbbbbbbbb
bbbbbbbbbbb
ccccccccccc
ccccccccccc
ccccccccccc
ddddddddddd
ddddddddddd
ddddddddddd
"}
