//MAP CONVERTED BY dmm2tgm.py THIS HEADER COMMENT PREVENTS RECONVERSION, DO NOT REMOVE
"a" = (
/turf/simulated/wall/r_wall,
/area/asteroid/cave)
"d" = (
/obj/spawner/junkfood/rotten/low_chance,
/turf/simulated/floor/plating/under/airless,
/area/asteroid/cave)
"e" = (
/obj/spawner/junk/low_chance,
/turf/simulated/floor/plating/under/airless,
/area/asteroid/cave)
"f" = (
/obj/effect/window_lwall_spawn/smartspawn,
/turf/simulated/floor/plating/airless,
/area/asteroid/cave)
"h" = (
/obj/structure/lattice,
/turf/simulated/floor/asteroid,
/area/asteroid/cave)
"i" = (
/obj/spawner/junk,
/obj/spawner/junk,
/obj/spawner/junk,
/obj/spawner/traps/wire_splicing/low_chance,
/turf/simulated/floor/plating/under/airless,
/area/asteroid/cave)
"j" = (
/obj/spawner/scrap/dense,
/turf/simulated/floor/plating/under/airless,
/area/asteroid/cave)
"k" = (
/obj/spawner/junk,
/turf/simulated/floor/plating/under/airless,
/area/asteroid/cave)
"l" = (
/obj/spawner/traps/wire_splicing/low_chance,
/turf/simulated/floor/plating/under/airless,
/area/asteroid/cave)
"n" = (
/mob/living/simple_animal/hostile/carp,
/turf/simulated/floor/plating/under/airless,
/area/asteroid/cave)
"o" = (
/obj/structure/railing,
/obj/spawner/traps/wire_splicing/low_chance,
/turf/simulated/floor/plating/under/airless,
/area/asteroid/cave)
"p" = (
/obj/structure/girder,
/turf/simulated/floor/plating/under/airless,
/area/asteroid/cave)

(1,1,1) = {"
h
a
a
p
h
"}
(2,1,1) = {"
d
f
j
k
n
"}
(3,1,1) = {"
k
f
i
l
o
"}
(4,1,1) = {"
a
a
a
a
p
"}
(5,1,1) = {"
e
a
h
h
p
"}
