"a" = (/turf/simulated/floor/plating/under,/area/template_noop)
"b" = (/turf/space,/area/template_noop)
"c" = (/obj/structure/lattice,/turf/space,/area/template_noop)
"d" = (/turf/simulated/wall/r_wall,/area/template_noop)
"e" = (/turf/simulated/floor/tiled/techmaint,/area/template_noop)
"f" = (/obj/structure/cable/green{d1 = 4; d2 = 8; icon_state = "4-8"},/obj/machinery/atmospherics/pipe/simple/hidden/red{dir = 4; tag = "icon-intact (EAST)"},/obj/structure/railing{dir = 1; tag = "icon-railing0 (NORTH)"},/obj/spawner/traps/wire_splicing/low_chance,/turf/simulated/floor/plating/under,/area/template_noop)
"g" = (/obj/structure/cable/green{d1 = 4; d2 = 8; icon_state = "4-8"},/obj/machinery/atmospherics/pipe/simple/hidden/red{dir = 4; tag = "icon-intact (EAST)"},/obj/structure/railing{dir = 1; tag = "icon-railing0 (NORTH)"},/obj/spawner/junk/low_chance,/turf/simulated/floor/plating/under,/area/template_noop)
"h" = (/obj/structure/cable/green{d1 = 4; d2 = 8; icon_state = "4-8"},/obj/machinery/atmospherics/pipe/simple/hidden/red{dir = 4; tag = "icon-intact (EAST)"},/obj/structure/railing{dir = 1; tag = "icon-railing0 (NORTH)"},/obj/spawner/scrap/dense,/turf/simulated/floor/plating/under,/area/template_noop)
"i" = (/obj/structure/cable/green{d1 = 4; d2 = 8; icon_state = "4-8"},/obj/machinery/atmospherics/pipe/simple/hidden/red{dir = 4; tag = "icon-intact (EAST)"},/obj/structure/railing{dir = 1; tag = "icon-railing0 (NORTH)"},/turf/simulated/floor/plating/under,/area/template_noop)
"j" = (/obj/machinery/atmospherics/pipe/simple/hidden/blue{dir = 4; tag = "icon-intact (EAST)"},/obj/spawner/junk/low_chance,/turf/simulated/floor/plating/under,/area/template_noop)
"k" = (/obj/structure/girder,/turf/simulated/floor/plating/under,/area/template_noop)
"l" = (/obj/structure/plushie/carp,/turf/simulated/floor/tiled/techmaint,/area/template_noop)
"m" = (/obj/spawner/junk/low_chance,/turf/simulated/floor/tiled/techmaint,/area/template_noop)
"n" = (/obj/machinery/atmospherics/pipe/simple/hidden/blue{dir = 4; tag = "icon-intact (EAST)"},/turf/simulated/floor/plating/under,/area/template_noop)

(1,1,1) = {"
bbbck
kdddd
almea
fghif
cnnjc
"}
