"a" = (/obj/spawner/junk,/turf/simulated/floor/plating/under,/area/template_noop)
"b" = (/turf/template_noop,/area/template_noop)
"d" = (/turf/simulated/wall/r_wall,/area/template_noop)
"e" = (/turf/simulated/floor/plating/under,/area/template_noop)
"f" = (/obj/structure/girder,/turf/simulated/floor/plating/under,/area/template_noop)
"g" = (/obj/spawner/junk/low_chance,/turf/simulated/floor/plating/under,/area/template_noop)
"h" = (/obj/spawner/scrap/sparse/low_chance,/turf/simulated/floor/plating/under,/area/template_noop)
"i" = (/obj/spawner/scrap/sparse,/turf/simulated/floor/plating/under,/area/template_noop)
"j" = (/mob/living/simple_animal/hostile/carp,/turf/simulated/floor/plating/under,/area/template_noop)
"D" = (/obj/structure/lattice,/turf/template_noop,/area/template_noop)

(1,1,1) = {"
aDfdD
aeghe
eijeD
Ddddf
efDbD
"}
