//MAP CONVERTED BY dmm2tgm.py THIS HEADER COMMENT PREVENTS RECONVERSION, DO NOT REMOVE
"a" = (
/obj/structure/lattice,
/obj/structure/railing{
	dir = 4;
	tag = "icon-railing0 (EAST)"
	},
/turf/space,
/area/template_noop)
"b" = (
/obj/structure/disposalpipe/segment{
	dir = 1;
	icon_state = "pipe-c"
	},
/obj/machinery/atmospherics/pipe/simple/hidden/supply{
	dir = 4
	},
/obj/machinery/atmospherics/pipe/simple/hidden/scrubbers{
	dir = 5
	},
/obj/structure/catwalk,
/obj/structure/cable/green{
	d1 = 4;
	d2 = 8;
	icon_state = "4-8"
	},
/obj/spawner/junk,
/turf/simulated/floor/plating/under,
/area/template_noop)
"c" = (
/obj/structure/disposalpipe/segment{
	dir = 4
	},
/obj/machinery/atmospherics/pipe/simple/hidden/supply{
	dir = 4
	},
/obj/machinery/atmospherics/pipe/simple/hidden/scrubbers{
	dir = 4
	},
/obj/structure/catwalk,
/obj/structure/cable/green{
	d1 = 4;
	d2 = 8;
	icon_state = "4-8"
	},
/turf/simulated/floor/plating/under,
/area/template_noop)
"d" = (
/obj/structure/disposalpipe/segment{
	dir = 4
	},
/obj/machinery/atmospherics/pipe/simple/hidden/supply{
	dir = 4
	},
/obj/machinery/atmospherics/pipe/simple/hidden/scrubbers{
	dir = 4
	},
/obj/structure/cable/green{
	d1 = 4;
	d2 = 8;
	icon_state = "4-8"
	},
/obj/structure/railing{
	dir = 8;
	tag = "icon-railing0 (WEST)"
	},
/obj/spawner/junkfood/rotten,
/turf/simulated/floor/plating/under,
/area/template_noop)
"f" = (
/obj/structure/girder,
/turf/simulated/floor/plating/under,
/area/template_noop)
"g" = (
/turf/simulated/wall/r_wall,
/area/template_noop)
"h" = (
/obj/machinery/door/firedoor,
/obj/machinery/door/airlock/maintenance_common{
	name = "Service Maintenance";
	req_access = list(12)
	},
/turf/simulated/floor/tiled/techmaint_cargo,
/area/template_noop)
"i" = (
/obj/structure/lattice,
/turf/space,
/area/template_noop)
"j" = (
/obj/spawner/traps/low_chance,
/turf/simulated/floor/tiled/techmaint,
/area/template_noop)
"k" = (
/obj/spawner/scrap/dense,
/turf/simulated/floor/tiled/techmaint,
/area/template_noop)
"l" = (
/turf/space,
/area/template_noop)

(1,1,1) = {"
a
f
i
l
l
"}
(2,1,1) = {"
b
g
g
g
l
"}
(3,1,1) = {"
c
h
j
g
i
"}
(4,1,1) = {"
d
g
k
g
l
"}
(5,1,1) = {"
i
g
g
g
l
"}
