"a" = (/obj/spawner/junk,/turf/simulated/floor/plating/under,/area/template_noop)
"b" = (/turf/space,/area/template_noop)
"c" = (/obj/structure/lattice,/turf/space,/area/template_noop)
"d" = (/turf/simulated/wall/r_wall,/area/template_noop)
"e" = (/turf/simulated/floor/plating/under,/area/template_noop)
"f" = (/obj/structure/girder,/turf/simulated/floor/plating/under,/area/template_noop)
"g" = (/obj/spawner/junk/low_chance,/turf/simulated/floor/plating/under,/area/template_noop)
"h" = (/obj/spawner/scrap/sparse/low_chance,/turf/simulated/floor/plating/under,/area/template_noop)
"i" = (/obj/spawner/scrap/sparse,/turf/simulated/floor/plating/under,/area/template_noop)
"j" = (/mob/living/simple_animal/hostile/carp,/turf/simulated/floor/plating/under,/area/template_noop)

(1,1,1) = {"
aefdf
aeghe
eijee
fdddd
bbcbb
"}
