"a" = (/obj/spawner/junk,/turf/simulated/floor/plating/under,/area/template_noop)
"b" = (/turf/simulated/floor/plating/under,/area/template_noop)
"c" = (/obj/structure/girder,/turf/simulated/floor/plating/under,/area/template_noop)
"d" = (/obj/effect/window_lwall_spawn/smartspawn,/turf/simulated/floor/plating,/area/template_noop)
"e" = (/obj/spawner/junk,/obj/spawner/scrap/sparse,/turf/simulated/floor/plating/under,/area/template_noop)
"f" = (/obj/spawner/scrap/dense,/turf/simulated/floor/tiled/techmaint,/area/template_noop)
"g" = (/mob/living/simple_animal/hostile/carp/pike,/turf/simulated/floor/tiled/techmaint,/area/template_noop)
"h" = (/turf/simulated/wall,/area/template_noop)
"i" = (/obj/spawner/pack/machine,/turf/simulated/floor/tiled/techmaint,/area/template_noop)
"j" = (/obj/structure/lattice,/turf/space,/area/template_noop)
"k" = (/obj/spawner/techpart,/turf/simulated/floor/tiled/techmaint,/area/template_noop)
"l" = (/obj/spawner/junkfood/rotten/low_chance,/turf/simulated/floor/plating/under,/area/template_noop)
"m" = (/obj/structure/lattice,/mob/living/simple_animal/hostile/carp,/turf/space,/area/template_noop)
"n" = (/obj/structure/cable/green{d1 = 4; d2 = 8; icon_state = "4-8"},/turf/simulated/floor/plating/under,/area/template_noop)
"o" = (/obj/structure/cable/green{d1 = 4; d2 = 8; icon_state = "4-8"},/obj/spawner/junk,/turf/simulated/floor/plating/under,/area/template_noop)
"p" = (/obj/structure/cable/green{d1 = 4; d2 = 8; icon_state = "4-8"},/obj/spawner/junkfood/rotten/low_chance,/turf/simulated/floor/plating/under,/area/template_noop)

(1,1,1) = {"
bdjbc
edfgh
dhikc
lhhac
mnopn
"}
