//MAP CONVERTED BY dmm2tgm.py THIS HEADER COMMENT PREVENTS RECONVERSION, DO NOT REMOVE
"a" = (
/obj/spawner/junk,
/turf/simulated/floor/plating/under,
/area/template_noop)
"b" = (
/obj/structure/lattice,
/turf/template_noop,
/area/template_noop)
"d" = (
/turf/simulated/wall/r_wall,
/area/template_noop)
"e" = (
/turf/simulated/floor/plating/under,
/area/template_noop)
"f" = (
/obj/structure/girder,
/turf/simulated/floor/plating/under,
/area/template_noop)
"g" = (
/obj/spawner/junk/low_chance,
/turf/simulated/floor/plating/under,
/area/template_noop)
"h" = (
/obj/spawner/scrap/sparse/low_chance,
/turf/simulated/floor/plating/under,
/area/template_noop)
"i" = (
/obj/spawner/scrap/sparse,
/turf/simulated/floor/plating/under,
/area/template_noop)
"j" = (
/mob/living/simple_animal/hostile/carp,
/turf/simulated/floor/plating/under,
/area/template_noop)
"k" = (
/turf/template_noop,
/area/template_noop)

(1,1,1) = {"
a
a
e
f
b
"}
(2,1,1) = {"
e
e
i
d
f
"}
(3,1,1) = {"
f
g
j
d
b
"}
(4,1,1) = {"
d
h
e
d
k
"}
(5,1,1) = {"
f
e
e
d
k
"}
